loop-location,icc-parallel,loop-absolute-size,loop-payload-fraction,loop-proper-sccs-number,loop-critical-payload-fraction,iterator-payload-total-cohesion,iterator-payload-non-cf-cohesion,critical-payload-total-cohesion,critical-payload-non-cf-cohesion,payload-total-dependencies-number,payload-true-dependencies-number,payload-anti-dependencies-number,critical-payload-total-dependencies-number,critical-payload-true-dependencies-number,critical-payload-anti-dependencies-number
/home/s1736883/Work/PParMetrics/benchmarks/snu-npb/nauseous-omp/BT/src/add.c(47),1,84,0.119,1,0.7,0.04444,0,0,0,20,10,10,20,10,10
/home/s1736883/Work/PParMetrics/benchmarks/snu-npb/nauseous-omp/BT/src/add.c(48),1,72,0.1389,1,0.7,0.05714,0,0,0,20,10,10,20,10,10
/home/s1736883/Work/PParMetrics/benchmarks/snu-npb/nauseous-omp/BT/src/add.c(49),1,60,0,0,0,0,0,0,0,0,0,0,0,0,0
/home/s1736883/Work/PParMetrics/benchmarks/snu-npb/nauseous-omp/BT/src/add.c(50),1,48,0.8125,1,0.07692,0.4078,0.02913,0.07895,0.07895,38,37,1,4,3,1
/home/s1736883/Work/PParMetrics/benchmarks/snu-npb/nauseous-omp/BT/src/bt.c(225),0,91,0.8242,1,0.1867,0.2651,0.01606,0.1049,0.08392,143,94,36,74,38,36
/home/s1736883/Work/PParMetrics/benchmarks/snu-npb/nauseous-omp/BT/src/bt.c(219),1,14,0.4286,0,0,0.2581,0.06452,0,0,3,3,0,0,0,0
/home/s1736883/Work/PParMetrics/benchmarks/snu-npb/nauseous-omp/BT/src/bt.c(187),0,20,0.25,0,0,0.1818,0.02273,0,0,0,0,0,0,0,0
/home/s1736883/Work/PParMetrics/benchmarks/snu-npb/nauseous-omp/BT/src/bt.c(182),1,10,0.3,0,0,0.1905,0.04762,0,0,0,0,0,0,0,0
/home/s1736883/Work/PParMetrics/benchmarks/snu-npb/nauseous-omp/BT/src/bt.c(168),1,10,0.3,0,0,0.1905,0.04762,0,0,0,0,0,0,0,0
/home/s1736883/Work/PParMetrics/benchmarks/snu-npb/nauseous-omp/BT/src/bt.c(139),0,5,0.2,0,0,0.125,0,0,0,0,0,0,0,0,0
/home/s1736883/Work/PParMetrics/benchmarks/snu-npb/nauseous-omp/BT/src/bt.c(137),0,5,0.2,0,0,0.125,0,0,0,0,0,0,0,0,0
/home/s1736883/Work/PParMetrics/benchmarks/snu-npb/nauseous-omp/BT/src/error.c(80),1,46,0.4348,2,0.55,0.2113,0.02817,0.0625,0.0625,32,20,12,26,14,12
/home/s1736883/Work/PParMetrics/benchmarks/snu-npb/nauseous-omp/BT/src/error.c(81),1,25,0.72,1,0.3333,0.3455,0.01818,0.1579,0.1579,19,17,2,9,7,2
/home/s1736883/Work/PParMetrics/benchmarks/snu-npb/nauseous-omp/BT/src/error.c(74),1,19,0.5789,1,0.2727,0.2955,0.04545,0.2727,0.2727,11,10,1,4,3,1
/home/s1736883/Work/PParMetrics/benchmarks/snu-npb/nauseous-omp/BT/src/error.c(59),1,95,0.1474,2,0.5714,0.08738,0.009709,0.04762,0.04762,21,12,9,18,9,9
/home/s1736883/Work/PParMetrics/benchmarks/snu-npb/nauseous-omp/BT/src/error.c(61),0,78,0.1795,2,0.5714,0.1059,0.01176,0.04762,0.04762,21,12,9,18,9,9
/home/s1736883/Work/PParMetrics/benchmarks/snu-npb/nauseous-omp/BT/src/error.c(63),0,61,0.3279,2,0.5,0.1842,0.01316,0.06061,0.06061,33,20,13,26,13,13
/home/s1736883/Work/PParMetrics/benchmarks/snu-npb/nauseous-omp/BT/src/error.c(67),0,39,0.7436,2,0.2069,0.3667,0.04444,0.1935,0.1935,31,28,3,8,5,3
/home/s1736883/Work/PParMetrics/benchmarks/snu-npb/nauseous-omp/BT/src/error.c(55),1,12,0.4167,0,0,0.24,0.04,0,0,2,2,0,0,0,0
/home/s1736883/Work/PParMetrics/benchmarks/snu-npb/nauseous-omp/BT/src/error.c(48),1,13,0.4615,0,0,0.2593,0.03704,0,0,3,3,0,0,0,0
/home/s1736883/Work/PParMetrics/benchmarks/snu-npb/nauseous-omp/BT/src/error.c(122),1,46,0.4348,2,0.55,0.2113,0.02817,0.0625,0.0625,32,20,12,26,14,12
/home/s1736883/Work/PParMetrics/benchmarks/snu-npb/nauseous-omp/BT/src/error.c(123),1,25,0.72,1,0.3333,0.3455,0.01818,0.1579,0.1579,19,17,2,9,7,2
/home/s1736883/Work/PParMetrics/benchmarks/snu-npb/nauseous-omp/BT/src/error.c(116),1,19,0.5789,1,0.2727,0.2955,0.04545,0.2727,0.2727,11,10,1,4,3,1
/home/s1736883/Work/PParMetrics/benchmarks/snu-npb/nauseous-omp/BT/src/error.c(106),1,70,0.1143,1,0.625,0.05405,0,0,0,12,6,6,12,6,6
/home/s1736883/Work/PParMetrics/benchmarks/snu-npb/nauseous-omp/BT/src/error.c(107),0,58,0.1379,1,0.625,0.06452,0,0,0,12,6,6,12,6,6
/home/s1736883/Work/PParMetrics/benchmarks/snu-npb/nauseous-omp/BT/src/error.c(108),0,46,0.2174,1,0.7,0.08,0,0,0,20,10,10,20,10,10
/home/s1736883/Work/PParMetrics/benchmarks/snu-npb/nauseous-omp/BT/src/error.c(109),1,34,0.7353,2,0.24,0.359,0.03846,0.2222,0.2222,27,24,3,8,5,3
/home/s1736883/Work/PParMetrics/benchmarks/snu-npb/nauseous-omp/BT/src/error.c(102),1,12,0.4167,0,0,0.24,0.04,0,0,2,2,0,0,0,0
/home/s1736883/Work/PParMetrics/benchmarks/snu-npb/nauseous-omp/BT/src/error.c(95),1,13,0.4615,0,0,0.2593,0.03704,0,0,3,3,0,0,0,0
/home/s1736883/Work/PParMetrics/benchmarks/snu-npb/nauseous-omp/BT/src/exact_rhs.c(355),1,71,0.1268,1,0.6667,0.05263,0,0,0,16,8,8,16,8,8
/home/s1736883/Work/PParMetrics/benchmarks/snu-npb/nauseous-omp/BT/src/exact_rhs.c(356),1,59,0,0,0,0,0,0,0,0,0,0,0,0,0
/home/s1736883/Work/PParMetrics/benchmarks/snu-npb/nauseous-omp/BT/src/exact_rhs.c(357),1,47,0,0,0,0,0,0,0,0,0,0,0,0,0
/home/s1736883/Work/PParMetrics/benchmarks/snu-npb/nauseous-omp/BT/src/exact_rhs.c(358),1,35,0.7714,1,0.1111,0.3867,0.02667,0.07692,0.07692,26,25,1,4,3,1
/home/s1736883/Work/PParMetrics/benchmarks/snu-npb/nauseous-omp/BT/src/exact_rhs.c(258),1,1078,0.002783,1,0.6667,0.001287,0.0006437,0.3333,0.3333,3,2,1,2,1,1
/home/s1736883/Work/PParMetrics/benchmarks/snu-npb/nauseous-omp/BT/src/exact_rhs.c(260),0,1061,0.002828,1,0.6667,0.001324,0.000662,0.3333,0.3333,3,2,1,2,1,1
/home/s1736883/Work/PParMetrics/benchmarks/snu-npb/nauseous-omp/BT/src/exact_rhs.c(263),1,156,0.6667,5,0.3654,0.2903,0.0457,0.1257,0.1257,191,135,56,124,68,56
/home/s1736883/Work/PParMetrics/benchmarks/snu-npb/nauseous-omp/BT/src/exact_rhs.c(283),1,517,0.94,3,0.1523,0.4189,0.01893,0.1195,0.1195,619,548,71,163,92,71
/home/s1736883/Work/PParMetrics/benchmarks/snu-npb/nauseous-omp/BT/src/exact_rhs.c(320),1,132,0.8712,2,0.1652,0.3772,0.03293,0.1056,0.1056,161,135,26,56,30,26
/home/s1736883/Work/PParMetrics/benchmarks/snu-npb/nauseous-omp/BT/src/exact_rhs.c(330),1,95,0,0,0,0,0,0,0,0,0,0,0,0,0
/home/s1736883/Work/PParMetrics/benchmarks/snu-npb/nauseous-omp/BT/src/exact_rhs.c(338),1,136,0.875,2,0.1597,0.3801,0.03216,0.1152,0.1152,165,139,26,56,30,26
/home/s1736883/Work/PParMetrics/benchmarks/snu-npb/nauseous-omp/BT/src/exact_rhs.c(267),0,19,0.5789,0,0,0.3171,0.04878,0,0,8,8,0,0,0,0
/home/s1736883/Work/PParMetrics/benchmarks/snu-npb/nauseous-omp/BT/src/exact_rhs.c(273),1,21,0.619,0,0,0.3333,0.04444,0,0,10,10,0,0,0,0
/home/s1736883/Work/PParMetrics/benchmarks/snu-npb/nauseous-omp/BT/src/exact_rhs.c(331),1,83,0.8434,1,0.04286,0.4254,0.03867,0.04348,0.04348,69,68,1,4,3,1
/home/s1736883/Work/PParMetrics/benchmarks/snu-npb/nauseous-omp/BT/src/exact_rhs.c(162),1,1078,0.002783,1,0.6667,0.001287,0.0006437,0.3333,0.3333,3,2,1,2,1,1
/home/s1736883/Work/PParMetrics/benchmarks/snu-npb/nauseous-omp/BT/src/exact_rhs.c(164),0,1061,0.002828,1,0.6667,0.001324,0.000662,0.3333,0.3333,3,2,1,2,1,1
/home/s1736883/Work/PParMetrics/benchmarks/snu-npb/nauseous-omp/BT/src/exact_rhs.c(167),1,156,0.6667,5,0.3654,0.2903,0.0457,0.1257,0.1257,191,135,56,124,68,56
/home/s1736883/Work/PParMetrics/benchmarks/snu-npb/nauseous-omp/BT/src/exact_rhs.c(187),1,517,0.94,3,0.1523,0.4189,0.01893,0.1195,0.1195,619,548,71,163,92,71
/home/s1736883/Work/PParMetrics/benchmarks/snu-npb/nauseous-omp/BT/src/exact_rhs.c(224),1,132,0.8712,2,0.1652,0.3772,0.03293,0.1056,0.1056,161,135,26,56,30,26
/home/s1736883/Work/PParMetrics/benchmarks/snu-npb/nauseous-omp/BT/src/exact_rhs.c(234),1,95,0,0,0,0,0,0,0,0,0,0,0,0,0
/home/s1736883/Work/PParMetrics/benchmarks/snu-npb/nauseous-omp/BT/src/exact_rhs.c(242),1,136,0.875,2,0.1597,0.3801,0.03216,0.1152,0.1152,165,139,26,56,30,26
/home/s1736883/Work/PParMetrics/benchmarks/snu-npb/nauseous-omp/BT/src/exact_rhs.c(171),0,19,0.5789,0,0,0.3171,0.04878,0,0,8,8,0,0,0,0
/home/s1736883/Work/PParMetrics/benchmarks/snu-npb/nauseous-omp/BT/src/exact_rhs.c(177),1,21,0.619,0,0,0.3333,0.04444,0,0,10,10,0,0,0,0
/home/s1736883/Work/PParMetrics/benchmarks/snu-npb/nauseous-omp/BT/src/exact_rhs.c(235),1,83,0.8434,1,0.04286,0.4254,0.03867,0.04348,0.04348,69,68,1,4,3,1
/home/s1736883/Work/PParMetrics/benchmarks/snu-npb/nauseous-omp/BT/src/exact_rhs.c(66),1,1078,0.002783,1,0.6667,0.001287,0.0006437,0.3333,0.3333,3,2,1,2,1,1
/home/s1736883/Work/PParMetrics/benchmarks/snu-npb/nauseous-omp/BT/src/exact_rhs.c(68),0,1061,0.002828,1,0.6667,0.001324,0.000662,0.3333,0.3333,3,2,1,2,1,1
/home/s1736883/Work/PParMetrics/benchmarks/snu-npb/nauseous-omp/BT/src/exact_rhs.c(71),1,156,0.6667,5,0.3654,0.2903,0.0457,0.1257,0.1257,191,135,56,124,68,56
/home/s1736883/Work/PParMetrics/benchmarks/snu-npb/nauseous-omp/BT/src/exact_rhs.c(91),1,517,0.94,3,0.1523,0.4189,0.01893,0.1195,0.1195,619,548,71,163,92,71
/home/s1736883/Work/PParMetrics/benchmarks/snu-npb/nauseous-omp/BT/src/exact_rhs.c(128),1,132,0.8712,2,0.1652,0.3772,0.03293,0.1056,0.1056,161,135,26,56,30,26
/home/s1736883/Work/PParMetrics/benchmarks/snu-npb/nauseous-omp/BT/src/exact_rhs.c(138),1,95,0,0,0,0,0,0,0,0,0,0,0,0,0
/home/s1736883/Work/PParMetrics/benchmarks/snu-npb/nauseous-omp/BT/src/exact_rhs.c(146),1,136,0.875,2,0.1597,0.3801,0.03216,0.1152,0.1152,165,139,26,56,30,26
/home/s1736883/Work/PParMetrics/benchmarks/snu-npb/nauseous-omp/BT/src/exact_rhs.c(75),0,19,0.5789,0,0,0.3171,0.04878,0,0,8,8,0,0,0,0
/home/s1736883/Work/PParMetrics/benchmarks/snu-npb/nauseous-omp/BT/src/exact_rhs.c(81),1,21,0.619,0,0,0.3333,0.04444,0,0,10,10,0,0,0,0
/home/s1736883/Work/PParMetrics/benchmarks/snu-npb/nauseous-omp/BT/src/exact_rhs.c(139),1,83,0.8434,1,0.04286,0.4254,0.03867,0.04348,0.04348,69,68,1,4,3,1
/home/s1736883/Work/PParMetrics/benchmarks/snu-npb/nauseous-omp/BT/src/exact_rhs.c(52),1,57,0.1404,1,0.625,0.06667,0,0,0,12,6,6,12,6,6
/home/s1736883/Work/PParMetrics/benchmarks/snu-npb/nauseous-omp/BT/src/exact_rhs.c(53),1,45,0,0,0,0,0,0,0,0,0,0,0,0,0
/home/s1736883/Work/PParMetrics/benchmarks/snu-npb/nauseous-omp/BT/src/exact_rhs.c(54),1,33,0.2424,1,0.625,0.1111,0,0,0,12,6,6,12,6,6
/home/s1736883/Work/PParMetrics/benchmarks/snu-npb/nauseous-omp/BT/src/exact_solution.c(44),0,114,0.8246,1,0.4043,0.3843,0.04982,0.2222,0.2222,117,104,13,63,50,13
/home/s1736883/Work/PParMetrics/benchmarks/snu-npb/nauseous-omp/BT/src/initialize.c(197),1,64,0.2188,2,0.5714,0.1268,0.01408,0.04762,0.04762,21,12,9,18,9,9
/home/s1736883/Work/PParMetrics/benchmarks/snu-npb/nauseous-omp/BT/src/initialize.c(199),1,47,0.383,2,0.4444,0.2258,0.01613,0.08,0.08,25,16,9,18,9,9
/home/s1736883/Work/PParMetrics/benchmarks/snu-npb/nauseous-omp/BT/src/initialize.c(202),0,25,0.68,0,0,0.3585,0.03774,0,0,14,14,0,0,0,0
/home/s1736883/Work/PParMetrics/benchmarks/snu-npb/nauseous-omp/BT/src/initialize.c(180),1,64,0.2188,2,0.5714,0.1268,0.01408,0.04762,0.04762,21,12,9,18,9,9
/home/s1736883/Work/PParMetrics/benchmarks/snu-npb/nauseous-omp/BT/src/initialize.c(182),1,47,0.383,2,0.4444,0.2258,0.01613,0.08,0.08,25,16,9,18,9,9
/home/s1736883/Work/PParMetrics/benchmarks/snu-npb/nauseous-omp/BT/src/initialize.c(185),0,25,0.68,0,0,0.3585,0.03774,0,0,14,14,0,0,0,0
/home/s1736883/Work/PParMetrics/benchmarks/snu-npb/nauseous-omp/BT/src/initialize.c(163),1,64,0.2188,2,0.5714,0.1268,0.01408,0.04762,0.04762,21,12,9,18,9,9
/home/s1736883/Work/PParMetrics/benchmarks/snu-npb/nauseous-omp/BT/src/initialize.c(165),1,47,0.383,2,0.4444,0.2258,0.01613,0.08,0.08,25,16,9,18,9,9
/home/s1736883/Work/PParMetrics/benchmarks/snu-npb/nauseous-omp/BT/src/initialize.c(168),0,25,0.68,0,0,0.3585,0.03774,0,0,14,14,0,0,0,0
/home/s1736883/Work/PParMetrics/benchmarks/snu-npb/nauseous-omp/BT/src/initialize.c(146),1,64,0.2188,2,0.5714,0.1268,0.01408,0.04762,0.04762,21,12,9,18,9,9
/home/s1736883/Work/PParMetrics/benchmarks/snu-npb/nauseous-omp/BT/src/initialize.c(148),1,47,0.383,2,0.4444,0.2258,0.01613,0.08,0.08,25,16,9,18,9,9
/home/s1736883/Work/PParMetrics/benchmarks/snu-npb/nauseous-omp/BT/src/initialize.c(151),0,25,0.68,0,0,0.3585,0.03774,0,0,14,14,0,0,0,0
/home/s1736883/Work/PParMetrics/benchmarks/snu-npb/nauseous-omp/BT/src/initialize.c(129),1,64,0.2188,2,0.5714,0.1268,0.01408,0.04762,0.04762,21,12,9,18,9,9
/home/s1736883/Work/PParMetrics/benchmarks/snu-npb/nauseous-omp/BT/src/initialize.c(131),1,47,0.383,2,0.4444,0.2258,0.01613,0.08,0.08,25,16,9,18,9,9
/home/s1736883/Work/PParMetrics/benchmarks/snu-npb/nauseous-omp/BT/src/initialize.c(134),0,25,0.68,0,0,0.3585,0.03774,0,0,14,14,0,0,0,0
/home/s1736883/Work/PParMetrics/benchmarks/snu-npb/nauseous-omp/BT/src/initialize.c(112),1,64,0.2188,2,0.5714,0.1268,0.01408,0.04762,0.04762,21,12,9,18,9,9
/home/s1736883/Work/PParMetrics/benchmarks/snu-npb/nauseous-omp/BT/src/initialize.c(114),1,47,0.383,2,0.4444,0.2258,0.01613,0.08,0.08,25,16,9,18,9,9
/home/s1736883/Work/PParMetrics/benchmarks/snu-npb/nauseous-omp/BT/src/initialize.c(117),0,25,0.68,0,0,0.3585,0.03774,0,0,14,14,0,0,0,0
/home/s1736883/Work/PParMetrics/benchmarks/snu-npb/nauseous-omp/BT/src/initialize.c(70),1,212,0.08019,2,0.6471,0.04523,0.005025,0.03704,0.03704,27,15,12,24,12,12
/home/s1736883/Work/PParMetrics/benchmarks/snu-npb/nauseous-omp/BT/src/initialize.c(72),0,195,0.08718,2,0.6471,0.05143,0.005714,0.03704,0.03704,27,15,12,24,12,12
/home/s1736883/Work/PParMetrics/benchmarks/snu-npb/nauseous-omp/BT/src/initialize.c(74),0,178,0.2416,5,0.7907,0.09554,0.006369,0.01053,0.01053,95,49,46,92,46,46
/home/s1736883/Work/PParMetrics/benchmarks/snu-npb/nauseous-omp/BT/src/initialize.c(77),0,18,0.5556,0,0,0.3077,0.05128,0,0,7,7,0,0,0,0
/home/s1736883/Work/PParMetrics/benchmarks/snu-npb/nauseous-omp/BT/src/initialize.c(81),0,18,0.5556,0,0,0.3077,0.05128,0,0,7,7,0,0,0,0
/home/s1736883/Work/PParMetrics/benchmarks/snu-npb/nauseous-omp/BT/src/initialize.c(85),0,18,0.5556,0,0,0.3077,0.05128,0,0,7,7,0,0,0,0
/home/s1736883/Work/PParMetrics/benchmarks/snu-npb/nauseous-omp/BT/src/initialize.c(89),1,101,0.8713,3,0.1705,0.4025,0.02966,0.1415,0.1415,106,94,12,24,12,12
/home/s1736883/Work/PParMetrics/benchmarks/snu-npb/nauseous-omp/BT/src/initialize.c(56),1,57,0.1404,1,0.625,0.06667,0,0,0,12,6,6,12,6,6
/home/s1736883/Work/PParMetrics/benchmarks/snu-npb/nauseous-omp/BT/src/initialize.c(57),1,45,0.1778,1,0.625,0.08333,0,0,0,12,6,6,12,6,6
/home/s1736883/Work/PParMetrics/benchmarks/snu-npb/nauseous-omp/BT/src/initialize.c(58),1,33,0,0,0,0,0,0,0,0,0,0,0,0,0
/home/s1736883/Work/PParMetrics/benchmarks/snu-npb/nauseous-omp/BT/src/initialize.c(59),1,21,0.6667,0,0,0.3488,0.02326,0,0,11,11,0,0,0,0
/home/s1736883/Work/PParMetrics/benchmarks/snu-npb/nauseous-omp/BT/src/initialize.c(229),1,66,0.09091,0,0,0.1408,0.05634,0,0,5,5,0,0,0,0
/home/s1736883/Work/PParMetrics/benchmarks/snu-npb/nauseous-omp/BT/src/initialize.c(230),1,44,0.7955,0,0,0.4176,0.03297,0,0,30,30,0,0,0,0
/home/s1736883/Work/PParMetrics/benchmarks/snu-npb/nauseous-omp/BT/src/initialize.c(220),1,66,0.09091,0,0,0.1408,0.05634,0,0,5,5,0,0,0,0
/home/s1736883/Work/PParMetrics/benchmarks/snu-npb/nauseous-omp/BT/src/initialize.c(221),1,44,0.7955,0,0,0.4176,0.03297,0,0,30,30,0,0,0,0
/home/s1736883/Work/PParMetrics/benchmarks/snu-npb/nauseous-omp/BT/src/rhs.c(432),1,72,0.125,1,0.6667,0.05263,0,0,0,16,8,8,16,8,8
/home/s1736883/Work/PParMetrics/benchmarks/snu-npb/nauseous-omp/BT/src/rhs.c(433),1,60,0,0,0,0,0,0,0,0,0,0,0,0,0
/home/s1736883/Work/PParMetrics/benchmarks/snu-npb/nauseous-omp/BT/src/rhs.c(434),1,48,0.1875,1,0.6667,0.09091,0,0,0,16,8,8,16,8,8
/home/s1736883/Work/PParMetrics/benchmarks/snu-npb/nauseous-omp/BT/src/rhs.c(435),1,36,0.7778,1,0.1071,0.3896,0.02597,0.1111,0.1111,27,26,1,4,3,1
/home/s1736883/Work/PParMetrics/benchmarks/snu-npb/nauseous-omp/BT/src/rhs.c(419),1,106,0,0,0,0,0,0,0,0,0,0,0,0,0
/home/s1736883/Work/PParMetrics/benchmarks/snu-npb/nauseous-omp/BT/src/rhs.c(420),1,94,0.1277,1,0.75,0.06452,0,0,0,28,14,14,28,14,14
/home/s1736883/Work/PParMetrics/benchmarks/snu-npb/nauseous-omp/BT/src/rhs.c(421),1,82,0.8659,1,0.04225,0.4343,0.02857,0.04286,0.04286,70,69,1,4,3,1
/home/s1736883/Work/PParMetrics/benchmarks/snu-npb/nauseous-omp/BT/src/rhs.c(407),1,122,0,0,0,0,0,0,0,0,0,0,0,0,0
/home/s1736883/Work/PParMetrics/benchmarks/snu-npb/nauseous-omp/BT/src/rhs.c(408),1,110,0,0,0,0,0,0,0,0,0,0,0,0,0
/home/s1736883/Work/PParMetrics/benchmarks/snu-npb/nauseous-omp/BT/src/rhs.c(409),1,98,0.8776,1,0.03488,0.4402,0.02871,0.03529,0.03529,85,84,1,4,3,1
/home/s1736883/Work/PParMetrics/benchmarks/snu-npb/nauseous-omp/BT/src/rhs.c(392),1,149,0,0,0,0,0,0,0,0,0,0,0,0,0
/home/s1736883/Work/PParMetrics/benchmarks/snu-npb/nauseous-omp/BT/src/rhs.c(393),1,137,0,0,0,0,0,0,0,0,0,0,0,0,0
/home/s1736883/Work/PParMetrics/benchmarks/snu-npb/nauseous-omp/BT/src/rhs.c(394),1,125,0.112,1,0.7857,0.05405,0,0,0,36,18,18,36,18,18
/home/s1736883/Work/PParMetrics/benchmarks/snu-npb/nauseous-omp/BT/src/rhs.c(395),1,113,0.885,1,0.03,0.444,0.02905,0.0303,0.0303,99,98,1,4,3,1
/home/s1736883/Work/PParMetrics/benchmarks/snu-npb/nauseous-omp/BT/src/rhs.c(381),1,122,0,0,0,0,0,0,0,0,0,0,0,0,0
/home/s1736883/Work/PParMetrics/benchmarks/snu-npb/nauseous-omp/BT/src/rhs.c(382),1,110,0,0,0,0,0,0,0,0,0,0,0,0,0
/home/s1736883/Work/PParMetrics/benchmarks/snu-npb/nauseous-omp/BT/src/rhs.c(383),1,98,0.8776,1,0.03488,0.4402,0.02871,0.03529,0.03529,85,84,1,4,3,1
/home/s1736883/Work/PParMetrics/benchmarks/snu-npb/nauseous-omp/BT/src/rhs.c(369),1,106,0,0,0,0,0,0,0,0,0,0,0,0,0
/home/s1736883/Work/PParMetrics/benchmarks/snu-npb/nauseous-omp/BT/src/rhs.c(370),1,94,0,0,0,0,0,0,0,0,0,0,0,0,0
/home/s1736883/Work/PParMetrics/benchmarks/snu-npb/nauseous-omp/BT/src/rhs.c(371),1,82,0.8659,1,0.04225,0.4343,0.02857,0.04286,0.04286,70,69,1,4,3,1
/home/s1736883/Work/PParMetrics/benchmarks/snu-npb/nauseous-omp/BT/src/rhs.c(312),1,840,0,0,0,0,0,0,0,0,0,0,0,0,0
/home/s1736883/Work/PParMetrics/benchmarks/snu-npb/nauseous-omp/BT/src/rhs.c(313),1,828,0,0,0,0,0,0,0,0,0,0,0,0,0
/home/s1736883/Work/PParMetrics/benchmarks/snu-npb/nauseous-omp/BT/src/rhs.c(314),1,816,0.9179,4,0.06142,0.4425,0.03231,0.05589,0.05589,823,781,42,105,63,42
/home/s1736883/Work/PParMetrics/benchmarks/snu-npb/nauseous-omp/BT/src/rhs.c(202),1,1403,0.0727,1,0.9804,0.001958,0.0003917,0.001357,0.001357,1474,738,736,1472,736,736
/home/s1736883/Work/PParMetrics/benchmarks/snu-npb/nauseous-omp/BT/src/rhs.c(203),1,828,0,0,0,0,0,0,0,0,0,0,0,0,0
/home/s1736883/Work/PParMetrics/benchmarks/snu-npb/nauseous-omp/BT/src/rhs.c(256),1,94,0,0,0,0,0,0,0,0,0,0,0,0,0
/home/s1736883/Work/PParMetrics/benchmarks/snu-npb/nauseous-omp/BT/src/rhs.c(265),1,110,0,0,0,0,0,0,0,0,0,0,0,0,0
/home/s1736883/Work/PParMetrics/benchmarks/snu-npb/nauseous-omp/BT/src/rhs.c(273),1,137,0,0,0,0,0,0,0,0,0,0,0,0,0
/home/s1736883/Work/PParMetrics/benchmarks/snu-npb/nauseous-omp/BT/src/rhs.c(285),1,110,0.1182,1,0.7692,0.05882,0,0,0,32,16,16,32,16,16
/home/s1736883/Work/PParMetrics/benchmarks/snu-npb/nauseous-omp/BT/src/rhs.c(294),1,94,0.1277,1,0.75,0.06452,0,0,0,28,14,14,28,14,14
/home/s1736883/Work/PParMetrics/benchmarks/snu-npb/nauseous-omp/BT/src/rhs.c(204),1,816,0.9179,4,0.06142,0.4425,0.03231,0.05589,0.05589,823,781,42,105,63,42
/home/s1736883/Work/PParMetrics/benchmarks/snu-npb/nauseous-omp/BT/src/rhs.c(257),1,82,0.8659,1,0.04225,0.4343,0.02857,0.04286,0.04286,70,69,1,4,3,1
/home/s1736883/Work/PParMetrics/benchmarks/snu-npb/nauseous-omp/BT/src/rhs.c(266),1,98,0.8776,1,0.03488,0.4402,0.02871,0.03529,0.03529,85,84,1,4,3,1
/home/s1736883/Work/PParMetrics/benchmarks/snu-npb/nauseous-omp/BT/src/rhs.c(274),1,125,0.112,1,0.7857,0.05405,0,0,0,36,18,18,36,18,18
/home/s1736883/Work/PParMetrics/benchmarks/snu-npb/nauseous-omp/BT/src/rhs.c(286),1,98,0.8776,1,0.03488,0.4402,0.02871,0.03529,0.03529,85,84,1,4,3,1
/home/s1736883/Work/PParMetrics/benchmarks/snu-npb/nauseous-omp/BT/src/rhs.c(295),1,82,0.8659,1,0.04225,0.4343,0.02857,0.04286,0.04286,70,69,1,4,3,1
/home/s1736883/Work/PParMetrics/benchmarks/snu-npb/nauseous-omp/BT/src/rhs.c(275),1,113,0.885,1,0.03,0.444,0.02905,0.0303,0.0303,99,98,1,4,3,1
/home/s1736883/Work/PParMetrics/benchmarks/snu-npb/nauseous-omp/BT/src/rhs.c(91),1,1379,0,0,0,0,0,0,0,0,0,0,0,0,0
/home/s1736883/Work/PParMetrics/benchmarks/snu-npb/nauseous-omp/BT/src/rhs.c(92),1,828,0.07971,1,0.9545,0.008547,0,0,0,244,122,122,244,122,122
/home/s1736883/Work/PParMetrics/benchmarks/snu-npb/nauseous-omp/BT/src/rhs.c(149),1,196,0,0,0,0,0,0,0,0,0,0,0,0,0
/home/s1736883/Work/PParMetrics/benchmarks/snu-npb/nauseous-omp/BT/src/rhs.c(165),1,137,0,0,0,0,0,0,0,0,0,0,0,0,0
/home/s1736883/Work/PParMetrics/benchmarks/snu-npb/nauseous-omp/BT/src/rhs.c(176),1,200,0.075,1,0.8667,0.02632,0.008772,0.04348,0.04348,46,24,22,44,22,22
/home/s1736883/Work/PParMetrics/benchmarks/snu-npb/nauseous-omp/BT/src/rhs.c(93),1,816,0.9179,4,0.06142,0.4425,0.03231,0.05589,0.05589,823,781,42,105,63,42
/home/s1736883/Work/PParMetrics/benchmarks/snu-npb/nauseous-omp/BT/src/rhs.c(151),1,82,0.8659,1,0.04225,0.4343,0.02857,0.04286,0.04286,70,69,1,4,3,1
/home/s1736883/Work/PParMetrics/benchmarks/snu-npb/nauseous-omp/BT/src/rhs.c(158),1,98,0.8776,1,0.03488,0.4402,0.02871,0.03529,0.03529,85,84,1,4,3,1
/home/s1736883/Work/PParMetrics/benchmarks/snu-npb/nauseous-omp/BT/src/rhs.c(166),1,125,0,0,0,0,0,0,0,0,0,0,0,0,0
/home/s1736883/Work/PParMetrics/benchmarks/snu-npb/nauseous-omp/BT/src/rhs.c(178),1,98,0.8776,1,0.03488,0.4402,0.02871,0.03529,0.03529,85,84,1,4,3,1
/home/s1736883/Work/PParMetrics/benchmarks/snu-npb/nauseous-omp/BT/src/rhs.c(185),1,82,0.8659,1,0.04225,0.4343,0.02857,0.04286,0.04286,70,69,1,4,3,1
/home/s1736883/Work/PParMetrics/benchmarks/snu-npb/nauseous-omp/BT/src/rhs.c(167),1,113,0.885,1,0.03,0.444,0.02905,0.0303,0.0303,99,98,1,4,3,1
/home/s1736883/Work/PParMetrics/benchmarks/snu-npb/nauseous-omp/BT/src/rhs.c(75),1,70,0.1286,1,0.6667,0.05405,0,0,0,16,8,8,16,8,8
/home/s1736883/Work/PParMetrics/benchmarks/snu-npb/nauseous-omp/BT/src/rhs.c(76),1,58,0,0,0,0,0,0,0,0,0,0,0,0,0
/home/s1736883/Work/PParMetrics/benchmarks/snu-npb/nauseous-omp/BT/src/rhs.c(77),1,46,0.1957,1,0.6667,0.09524,0,0,0,16,8,8,16,8,8
/home/s1736883/Work/PParMetrics/benchmarks/snu-npb/nauseous-omp/BT/src/rhs.c(78),1,34,0.7647,0,0,0.3944,0.02817,0,0,23,23,0,0,0,0
/home/s1736883/Work/PParMetrics/benchmarks/snu-npb/nauseous-omp/BT/src/rhs.c(52),1,233,0,0,0,0,0,0,0,0,0,0,0,0,0
/home/s1736883/Work/PParMetrics/benchmarks/snu-npb/nauseous-omp/BT/src/rhs.c(53),1,221,0,0,0,0,0,0,0,0,0,0,0,0,0
/home/s1736883/Work/PParMetrics/benchmarks/snu-npb/nauseous-omp/BT/src/rhs.c(54),1,209,0.8804,2,0.04891,0.4379,0.03704,0.0582,0.0582,189,182,7,14,7,7
/home/s1736883/Work/PParMetrics/benchmarks/snu-npb/nauseous-omp/BT/src/verify.c(323),0,63,0.2857,0,0,0.1867,0.06667,0,0,9,9,0,0,0,0
/home/s1736883/Work/PParMetrics/benchmarks/snu-npb/nauseous-omp/BT/src/verify.c(304),0,63,0.2857,0,0,0.1867,0.06667,0,0,9,9,0,0,0,0
/home/s1736883/Work/PParMetrics/benchmarks/snu-npb/nauseous-omp/BT/src/verify.c(278),1,46,0.6957,0,0,0.3774,0.07547,0,0,28,28,0,0,0,0
/home/s1736883/Work/PParMetrics/benchmarks/snu-npb/nauseous-omp/BT/src/verify.c(68),0,16,0.5,0,0,0.2941,0.05882,0,0,4,4,0,0,0,0
/home/s1736883/Work/PParMetrics/benchmarks/snu-npb/nauseous-omp/BT/src/verify.c(61),0,18,0.5556,1,0.3,0.2927,0.04878,0.3333,0.3333,9,8,1,4,3,1
/home/s1736883/Work/PParMetrics/benchmarks/snu-npb/nauseous-omp/BT/src/x_solve.c(72),1,2993,0,0,0,0,0,0,0,0,0,0,0,0,0
/home/s1736883/Work/PParMetrics/benchmarks/snu-npb/nauseous-omp/BT/src/x_solve.c(73),0,2981,0.1245,1,0.8625,0.005892,0.001453,0.0001985,0.0001985,5038,2542,2496,4992,2496,2496
/home/s1736883/Work/PParMetrics/benchmarks/snu-npb/nauseous-omp/BT/src/x_solve.c(74),1,921,0.8936,3,0.04374,0.4487,0.04467,0.04317,0.04317,834,801,33,66,33,33
/home/s1736883/Work/PParMetrics/benchmarks/snu-npb/nauseous-omp/BT/src/x_solve.c(154),1,1813,0.8853,2,0.08847,0.4268,0.04729,0.07863,0.07863,1806,1666,140,280,140,140
/home/s1736883/Work/PParMetrics/benchmarks/snu-npb/nauseous-omp/BT/src/x_solve.c(346),0,75,0.7733,0,0,0.4061,0.05455,0,0,53,53,0,0,0,0
/home/s1736883/Work/PParMetrics/benchmarks/snu-npb/nauseous-omp/BT/src/x_solve.c(386),0,81,0,0,0,0,0,0,0,0,0,0,0,0,0
/home/s1736883/Work/PParMetrics/benchmarks/snu-npb/nauseous-omp/BT/src/x_solve.c(387),1,71,0,0,0,0,0,0,0,0,0,0,0,0,0
/home/s1736883/Work/PParMetrics/benchmarks/snu-npb/nauseous-omp/BT/src/x_solve.c(388),0,61,0.8689,1,0.09434,0.4264,0.0155,0.07407,0.07407,54,52,2,8,6,2
/home/s1736883/Work/PParMetrics/benchmarks/snu-npb/nauseous-omp/BT/src/y_solve.c(71),1,2983,0,0,0,0,0,0,0,0,0,0,0,0,0
/home/s1736883/Work/PParMetrics/benchmarks/snu-npb/nauseous-omp/BT/src/y_solve.c(72),0,2971,0.1326,1,0.8096,0.006707,0.0003232,0.0001984,0.0001984,5040,2552,2488,4976,2488,2488
/home/s1736883/Work/PParMetrics/benchmarks/snu-npb/nauseous-omp/BT/src/y_solve.c(73),1,911,0.8935,3,0.04545,0.4482,0.04462,0.04474,0.04474,827,793,34,68,34,34
/home/s1736883/Work/PParMetrics/benchmarks/snu-npb/nauseous-omp/BT/src/y_solve.c(152),1,1813,0.8853,2,0.08847,0.4268,0.04729,0.07863,0.07863,1806,1666,140,280,140,140
/home/s1736883/Work/PParMetrics/benchmarks/snu-npb/nauseous-omp/BT/src/y_solve.c(340),0,75,0.7733,0,0,0.4061,0.05455,0,0,53,53,0,0,0,0
/home/s1736883/Work/PParMetrics/benchmarks/snu-npb/nauseous-omp/BT/src/y_solve.c(383),0,81,0.1235,1,0.7,0.06061,0,0,0,20,10,10,20,10,10
/home/s1736883/Work/PParMetrics/benchmarks/snu-npb/nauseous-omp/BT/src/y_solve.c(384),1,71,0,0,0,0,0,0,0,0,0,0,0,0,0
/home/s1736883/Work/PParMetrics/benchmarks/snu-npb/nauseous-omp/BT/src/y_solve.c(385),0,61,0.8689,1,0.09434,0.4264,0.0155,0.07407,0.07407,54,52,2,8,6,2
/home/s1736883/Work/PParMetrics/benchmarks/snu-npb/nauseous-omp/BT/src/z_solve.c(71),1,2986,0,0,0,0,0,0,0,0,0,0,0,0,0
/home/s1736883/Work/PParMetrics/benchmarks/snu-npb/nauseous-omp/BT/src/z_solve.c(72),0,2974,0.1241,1,0.8645,0.005819,0.001455,0.0001992,0.0001992,5021,2533,2488,4976,2488,2488
/home/s1736883/Work/PParMetrics/benchmarks/snu-npb/nauseous-omp/BT/src/z_solve.c(73),1,915,0.894,3,0.04523,0.4484,0.04444,0.04452,0.04452,831,797,34,68,34,34
/home/s1736883/Work/PParMetrics/benchmarks/snu-npb/nauseous-omp/BT/src/z_solve.c(153),1,1813,0.8853,2,0.08847,0.4268,0.04729,0.07863,0.07863,1806,1666,140,280,140,140
/home/s1736883/Work/PParMetrics/benchmarks/snu-npb/nauseous-omp/BT/src/z_solve.c(345),0,75,0.7733,0,0,0.4061,0.05455,0,0,53,53,0,0,0,0
/home/s1736883/Work/PParMetrics/benchmarks/snu-npb/nauseous-omp/BT/src/z_solve.c(397),0,81,0.1235,1,0.7,0.06061,0,0,0,20,10,10,20,10,10
/home/s1736883/Work/PParMetrics/benchmarks/snu-npb/nauseous-omp/BT/src/z_solve.c(398),1,71,0,0,0,0,0,0,0,0,0,0,0,0,0
/home/s1736883/Work/PParMetrics/benchmarks/snu-npb/nauseous-omp/BT/src/z_solve.c(399),0,61,0.8689,1,0.09434,0.4264,0.0155,0.07407,0.07407,54,52,2,8,6,2
/home/s1736883/Work/PParMetrics/benchmarks/snu-npb/nauseous-omp/common/randdp.c(122),0,67,0.8806,1,0.7966,0.3571,0.005952,0.08989,0.08989,89,68,21,79,58,21
/home/s1736883/Work/PParMetrics/benchmarks/snu-npb/nauseous-omp/CG/src/cg.c(417),0,46,0.7174,1,0.2727,0.2241,0.03448,0.2105,0.1228,57,34,12,26,14,12
/home/s1736883/Work/PParMetrics/benchmarks/snu-npb/nauseous-omp/CG/src/cg.c(326),0,100,0.51,4,0.549,0.1676,0.01117,0.02362,0.02362,127,67,54,111,57,54
/home/s1736883/Work/PParMetrics/benchmarks/snu-npb/nauseous-omp/CG/src/cg.c(344),1,36,0.6111,2,0.2727,0.3171,0.04878,0.09091,0.09091,22,20,2,8,6,2
/home/s1736883/Work/PParMetrics/benchmarks/snu-npb/nauseous-omp/CG/src/cg.c(360),1,22,0.4545,0,0,0.2553,0.04255,0,0,7,7,0,0,0,0
/home/s1736883/Work/PParMetrics/benchmarks/snu-npb/nauseous-omp/CG/src/cg.c(309),1,12,0.4167,0,0,0.24,0.04,0,0,2,2,0,0,0,0
/home/s1736883/Work/PParMetrics/benchmarks/snu-npb/nauseous-omp/CG/src/cg.c(288),1,36,0.6111,2,0.2727,0.3171,0.04878,0.09091,0.09091,22,20,2,8,6,2
/home/s1736883/Work/PParMetrics/benchmarks/snu-npb/nauseous-omp/CG/src/cg.c(299),1,22,0.4545,0,0,0.2553,0.04255,0,0,7,7,0,0,0,0
/home/s1736883/Work/PParMetrics/benchmarks/snu-npb/nauseous-omp/CG/src/cg.c(257),1,28,0.5,0,0,0.3,0.06667,0,0,8,8,0,0,0,0
/home/s1736883/Work/PParMetrics/benchmarks/snu-npb/nauseous-omp/CG/src/cg.c(253),1,12,0.4167,0,0,0.24,0.04,0,0,2,2,0,0,0,0
/home/s1736883/Work/PParMetrics/benchmarks/snu-npb/nauseous-omp/CG/src/cg.c(243),1,41,0.2927,1,0.5,0.1429,0.01786,0.05263,0.05263,19,11,8,16,8,8
/home/s1736883/Work/PParMetrics/benchmarks/snu-npb/nauseous-omp/CG/src/cg.c(157),1,10,0.3,0,0,0.1905,0.04762,0,0,0,0,0,0,0,0
/home/s1736883/Work/PParMetrics/benchmarks/snu-npb/nauseous-omp/CG/src/cg.c(700),0,69,0.4928,3,0.5,0.2105,0.01754,0.03636,0.03636,55,34,21,42,21,21
/home/s1736883/Work/PParMetrics/benchmarks/snu-npb/nauseous-omp/CG/src/cg.c(706),1,34,0.6765,1,0.2174,0.3293,0.04878,0.1481,0.1481,27,23,4,11,7,4
/home/s1736883/Work/PParMetrics/benchmarks/snu-npb/nauseous-omp/CG/src/cg.c(616),1,30,0.6,2,0.3333,0.2941,0.02941,0.2,0.2,20,17,3,8,5,3
/home/s1736883/Work/PParMetrics/benchmarks/snu-npb/nauseous-omp/CG/src/cg.c(604),1,58,0.431,3,0.64,0.1818,0.02273,0.04762,0.04762,42,25,17,34,17,17
/home/s1736883/Work/PParMetrics/benchmarks/snu-npb/nauseous-omp/CG/src/cg.c(606),1,32,0.5625,1,0.1667,0.2899,0.02899,0.05882,0.05882,17,16,1,4,3,1
/home/s1736883/Work/PParMetrics/benchmarks/snu-npb/nauseous-omp/CG/src/cg.c(484),0,205,0.278,6,0.8596,0.03648,0,0.01425,0.01425,421,214,207,414,207,207
/home/s1736883/Work/PParMetrics/benchmarks/snu-npb/nauseous-omp/CG/src/cg.c(509),1,58,0.431,3,0.64,0.1818,0.02273,0.04762,0.04762,42,25,17,34,17,17
/home/s1736883/Work/PParMetrics/benchmarks/snu-npb/nauseous-omp/CG/src/cg.c(559),1,26,0.5385,1,0.2143,0.2807,0.03509,0.07692,0.07692,13,12,1,4,3,1
/home/s1736883/Work/PParMetrics/benchmarks/snu-npb/nauseous-omp/CG/src/cg.c(573),1,62,0.7097,2,0.3409,0.319,0.04908,0.2,0.2,65,52,13,36,23,13
/home/s1736883/Work/PParMetrics/benchmarks/snu-npb/nauseous-omp/CG/src/cg.c(593),1,30,0.5667,1,0.2941,0.2899,0.04348,0.2222,0.2222,18,16,2,8,6,2
/home/s1736883/Work/PParMetrics/benchmarks/snu-npb/nauseous-omp/CG/src/cg.c(511),1,32,0.5625,1,0.1667,0.2899,0.02899,0.05882,0.05882,17,16,1,4,3,1
/home/s1736883/Work/PParMetrics/benchmarks/snu-npb/nauseous-omp/CG/src/cg.c(475),1,26,0.5385,1,0.2143,0.2807,0.03509,0.07692,0.07692,13,12,1,4,3,1
/home/s1736883/Work/PParMetrics/benchmarks/snu-npb/nauseous-omp/CG/src/cg.c(463),1,40,0.65,1,0.2308,0.3077,0.05769,0.1667,0.1667,36,28,8,18,10,8
/home/s1736883/Work/PParMetrics/benchmarks/snu-npb/nauseous-omp/CG/src/cg.c(933),1,27,0.5926,1,0.5,0.2836,0.04478,0.1429,0.1429,21,17,4,15,11,4
/home/s1736883/Work/PParMetrics/benchmarks/snu-npb/nauseous-omp/CG/src/cg.c(918),1,82,0.5976,5,0.6327,0.226,0.02825,0.1111,0.1111,99,62,37,80,43,37
/home/s1736883/Work/PParMetrics/benchmarks/snu-npb/nauseous-omp/CG/src/cg.c(926),1,32,0.7188,2,0.3913,0.3165,0.02532,0.1875,0.1875,32,25,7,18,11,7
/home/s1736883/Work/PParMetrics/benchmarks/snu-npb/nauseous-omp/CG/src/cg.c(911),1,21,0.5714,1,0.25,0.2979,0.04255,0.2727,0.2727,11,10,1,4,3,1
/home/s1736883/Work/PParMetrics/benchmarks/snu-npb/nauseous-omp/CG/src/cg.c(906),1,17,0.5294,1,0.3333,0.2703,0.02703,0.125,0.125,8,7,1,4,3,1
/home/s1736883/Work/PParMetrics/benchmarks/snu-npb/nauseous-omp/CG/src/cg.c(898),0,26,0.6154,1,0.25,0.3115,0.04918,0.1765,0.1765,17,15,2,7,5,2
/home/s1736883/Work/PParMetrics/benchmarks/snu-npb/nauseous-omp/CG/src/cg.c(836),0,251,0.05179,2,0.7692,0.006494,0.006494,0.04,0,25,13,10,22,12,10
/home/s1736883/Work/PParMetrics/benchmarks/snu-npb/nauseous-omp/CG/src/cg.c(837),0,236,0.01271,1,0.6667,0.007828,0.003914,0.3333,0.3333,3,2,1,2,1,1
/home/s1736883/Work/PParMetrics/benchmarks/snu-npb/nauseous-omp/CG/src/cg.c(843),0,192,0.6719,2,0.9147,0.01594,0.01594,0.01822,0.01012,494,251,172,482,243,172
/home/s1736883/Work/PParMetrics/benchmarks/snu-npb/nauseous-omp/CG/src/cg.c(856),0,39,0.1026,0,0,0.05063,0,0,0,0,0,0,0,0,0
/home/s1736883/Work/PParMetrics/benchmarks/snu-npb/nauseous-omp/CG/src/cg.c(861),0,39,0.07692,0,0,0.03125,0,0,0,0,0,0,0,0,0
/home/s1736883/Work/PParMetrics/benchmarks/snu-npb/nauseous-omp/CG/src/cg.c(822),0,45,0.4667,2,0.6667,0.1647,0.02353,0.04255,0.04255,47,27,20,42,22,20
/home/s1736883/Work/PParMetrics/benchmarks/snu-npb/nauseous-omp/CG/src/cg.c(823),1,24,0.08333,0,0,0.03448,0,0,0,0,0,0,0,0,0
/home/s1736883/Work/PParMetrics/benchmarks/snu-npb/nauseous-omp/CG/src/cg.c(798),1,21,0.5714,1,0.5833,0.2745,0.03922,0.2,0.2,15,12,3,12,9,3
/home/s1736883/Work/PParMetrics/benchmarks/snu-npb/nauseous-omp/CG/src/cg.c(793),1,17,0.5294,1,0.3333,0.2703,0.02703,0.125,0.125,8,7,1,4,3,1
/home/s1736883/Work/PParMetrics/benchmarks/snu-npb/nauseous-omp/CG/src/cg.c(785),0,26,0.6154,1,0.625,0.2836,0.04478,0.1304,0.1304,23,18,5,19,14,5
/home/s1736883/Work/PParMetrics/benchmarks/snu-npb/nauseous-omp/CG/src/cg.c(771),0,61,0.1311,1,0.625,0.05714,0,0,0,12,6,6,12,6,6
/home/s1736883/Work/PParMetrics/benchmarks/snu-npb/nauseous-omp/CG/src/cg.c(772),1,50,0.06,0,0,0.02344,0,0,0,0,0,0,0,0,0
/home/s1736883/Work/PParMetrics/benchmarks/snu-npb/nauseous-omp/CG/src/cg.c(767),0,14,0.4286,1,0.5,0.2258,0.03226,0.2,0.2,5,4,1,4,3,1
/home/s1736883/Work/PParMetrics/benchmarks/snu-npb/nauseous-omp/common/randdp.c(122),0,67,0.8806,1,0.7966,0.3571,0.005952,0.08989,0.08989,89,68,21,79,58,21
/home/s1736883/Work/PParMetrics/benchmarks/snu-npb/nauseous-omp/DC/src/adc.c(44),0,63,0.4921,0,0,0.2481,0.03101,0,0,25,22,0,0,0,0
/home/s1736883/Work/PParMetrics/benchmarks/snu-npb/nauseous-omp/DC/src/adc.c(77),0,57,0.3684,3,0.7143,0.1463,0.0122,0.05714,0.05714,35,20,15,32,17,15
/home/s1736883/Work/PParMetrics/benchmarks/snu-npb/nauseous-omp/DC/src/adc.c(79),0,32,0.0625,0,0,0.02899,0,0,0,0,0,0,0,0,0
/home/s1736883/Work/PParMetrics/benchmarks/snu-npb/nauseous-omp/DC/src/adc.c(138),0,37,0.08108,0,0,0.06452,0.06452,0,0,2,1,0,0,0,0
/home/s1736883/Work/PParMetrics/benchmarks/snu-npb/nauseous-omp/DC/src/adc.c(139),0,26,0.03846,0,0,0.01667,0,0,0,0,0,0,0,0,0
/home/s1736883/Work/PParMetrics/benchmarks/snu-npb/nauseous-omp/DC/src/adc.c(117),0,121,0.686,1,0.9759,0.02885,0.009615,0.00495,0.00495,202,104,43,200,102,43
/home/s1736883/Work/PParMetrics/benchmarks/snu-npb/nauseous-omp/DC/src/adc.c(121),0,44,0.04545,0,0,0.02222,0,0,0,0,0,0,0,0,0
/home/s1736883/Work/PParMetrics/benchmarks/snu-npb/nauseous-omp/DC/src/adc.c(103),0,16,0.125,0,0,0.05714,0,0,0,0,0,0,0,0,0
/home/s1736883/Work/PParMetrics/benchmarks/snu-npb/nauseous-omp/DC/src/adc.c(156),0,144,0.07639,1,0.2727,0.01803,0,0,0,4,3,1,4,3,1
/home/s1736883/Work/PParMetrics/benchmarks/snu-npb/nauseous-omp/DC/src/adc.c(211),0,159,0.1698,2,0.5926,0.0177,0.003933,0,0,73,37,36,72,36,36
/home/s1736883/Work/PParMetrics/benchmarks/snu-npb/nauseous-omp/DC/src/adc.c(214),0,10,0.4,1,0.75,0.1818,0,0,0,4,3,1,4,3,1
/home/s1736883/Work/PParMetrics/benchmarks/snu-npb/nauseous-omp/DC/src/adc.c(223),0,23,0.08696,0,0,0.02778,0,0,0,0,0,0,0,0,0
/home/s1736883/Work/PParMetrics/benchmarks/snu-npb/nauseous-omp/DC/src/adc.c(228),0,31,0.06452,0,0,0.02941,0,0,0,0,0,0,0,0,0
/home/s1736883/Work/PParMetrics/benchmarks/snu-npb/nauseous-omp/DC/src/adc.c(203),0,23,0.08696,0,0,0.02128,0,0,0,0,0,0,0,0,0
/home/s1736883/Work/PParMetrics/benchmarks/snu-npb/nauseous-omp/DC/src/adc.c(191),0,23,0.08696,0,0,0.02128,0,0,0,0,0,0,0,0,0
/home/s1736883/Work/PParMetrics/benchmarks/snu-npb/nauseous-omp/DC/src/adc.c(375),0,74,0.3784,5,0.6429,0.1739,0.02899,0.05,0.05,40,25,15,34,19,15
/home/s1736883/Work/PParMetrics/benchmarks/snu-npb/nauseous-omp/DC/src/adc.c(379),0,24,0.375,1,0.3333,0.2,0.02,0,0,6,5,1,4,3,1
/home/s1736883/Work/PParMetrics/benchmarks/snu-npb/nauseous-omp/DC/src/adc.c(342),1,56,0.1964,0,0,0.1037,0.02222,0,0,3,3,0,0,0,0
/home/s1736883/Work/PParMetrics/benchmarks/snu-npb/nauseous-omp/DC/src/adc.c(319),0,60,0.15,0,0,0.04839,0,0,0,0,0,0,0,0,0
/home/s1736883/Work/PParMetrics/benchmarks/snu-npb/nauseous-omp/DC/src/adc.c(411),0,88,0.7273,3,0.6406,0.075,0.00625,0.259,0.1079,139,68,32,79,47,32
/home/s1736883/Work/PParMetrics/benchmarks/snu-npb/nauseous-omp/DC/src/adc.c(414),0,23,0.1304,0,0,0.06897,0,0,0,0,0,0,0,0,0
/home/s1736883/Work/PParMetrics/benchmarks/snu-npb/nauseous-omp/DC/src/adc.c(571),1,39,0.7179,1,0.3214,0.3299,0.04124,0.2162,0.2162,37,31,6,19,13,6
/home/s1736883/Work/PParMetrics/benchmarks/snu-npb/nauseous-omp/DC/src/adc.c(565),1,69,0.04348,0,0,0.01463,0,0,0,0,0,0,0,0,0
/home/s1736883/Work/PParMetrics/benchmarks/snu-npb/nauseous-omp/DC/src/adc.c(558),0,33,0.6364,1,0.09524,0.3421,0.06579,0.2105,0.2105,19,18,1,2,1,1
/home/s1736883/Work/PParMetrics/benchmarks/snu-npb/nauseous-omp/DC/src/adc.c(549),1,57,0.2456,1,0.8571,0.1176,0.02353,0.06667,0.06667,30,18,12,28,16,12
/home/s1736883/Work/PParMetrics/benchmarks/snu-npb/nauseous-omp/DC/src/adc.c(551),0,33,0.6061,1,0.5,0.2778,0,0.08333,0.08333,24,20,4,16,12,4
/home/s1736883/Work/PParMetrics/benchmarks/snu-npb/nauseous-omp/DC/src/adc.c(607),0,78,0.1795,1,0.7143,0.06061,0,0,0,48,24,24,48,24,24
/home/s1736883/Work/PParMetrics/benchmarks/snu-npb/nauseous-omp/DC/src/adc.c(616),0,27,0.7037,1,0.1579,0.3148,0.01852,0.1667,0.1667,18,13,2,5,3,2
/home/s1736883/Work/PParMetrics/benchmarks/snu-npb/nauseous-omp/DC/src/adc.c(621),0,28,0.7143,0,0,0.3462,0.01923,0,0,15,12,0,0,0,0
/home/s1736883/Work/PParMetrics/benchmarks/snu-npb/nauseous-omp/DC/src/extbuild.c(26),0,21,0.1905,1,0.75,0.09091,0,0,0,4,3,1,4,3,1
/home/s1736883/Work/PParMetrics/benchmarks/snu-npb/nauseous-omp/DC/src/extbuild.c(57),0,47,0.6596,1,0.129,0.3298,0,0.06667,0.06667,30,28,2,6,4,2
/home/s1736883/Work/PParMetrics/benchmarks/snu-npb/nauseous-omp/DC/src/extbuild.c(556),0,32,0.75,2,0.4167,0.3521,0.01408,0.1852,0.1852,27,24,3,14,11,3
/home/s1736883/Work/PParMetrics/benchmarks/snu-npb/nauseous-omp/DC/src/extbuild.c(129),0,367,0.485,6,0.9045,0.0005144,0.0005144,0.01497,0.005879,1871,931,902,1818,914,902
/home/s1736883/Work/PParMetrics/benchmarks/snu-npb/nauseous-omp/DC/src/extbuild.c(136),0,320,0.1406,3,0.2889,0.03604,0.007871,0.02564,0.02564,39,30,9,24,15,9
/home/s1736883/Work/PParMetrics/benchmarks/snu-npb/nauseous-omp/DC/src/extbuild.c(545),1,45,0.04444,0,0,0.01449,0,0,0,0,0,0,0,0,0
/home/s1736883/Work/PParMetrics/benchmarks/snu-npb/nauseous-omp/DC/src/extbuild.c(471),0,21,0.09524,0,0,0.04651,0,0,0,0,0,0,0,0,0
/home/s1736883/Work/PParMetrics/benchmarks/snu-npb/nauseous-omp/DC/src/extbuild.c(480),0,82,0.4878,1,0.05,0.259,0.01807,0.06061,0.06061,33,32,1,2,1,1
/home/s1736883/Work/PParMetrics/benchmarks/snu-npb/nauseous-omp/DC/src/extbuild.c(509),1,23,0.08696,0,0,0.03448,0,0,0,0,0,0,0,0,0
/home/s1736883/Work/PParMetrics/benchmarks/snu-npb/nauseous-omp/DC/src/extbuild.c(515),1,45,0.04444,0,0,0.01449,0,0,0,0,0,0,0,0,0
/home/s1736883/Work/PParMetrics/benchmarks/snu-npb/nauseous-omp/DC/src/extbuild.c(523),1,39,0.7179,2,0.2143,0.275,0.025,0.1875,0,32,22,2,8,6,2
/home/s1736883/Work/PParMetrics/benchmarks/snu-npb/nauseous-omp/DC/src/extbuild.c(459),0,23,0.5652,0,0,0.2979,0.02128,0,0,10,10,0,0,0,0
/home/s1736883/Work/PParMetrics/benchmarks/snu-npb/nauseous-omp/DC/src/extbuild.c(310),1,43,0.04651,0,0,0.01587,0,0,0,0,0,0,0,0,0
/home/s1736883/Work/PParMetrics/benchmarks/snu-npb/nauseous-omp/DC/src/extbuild.c(265),1,211,0.1043,1,0.09091,0.07692,0.03628,0.1333,0.1333,15,14,1,2,1,1
/home/s1736883/Work/PParMetrics/benchmarks/snu-npb/nauseous-omp/DC/src/extbuild.c(284),1,23,0.08696,0,0,0.03448,0,0,0,0,0,0,0,0,0
/home/s1736883/Work/PParMetrics/benchmarks/snu-npb/nauseous-omp/DC/src/extbuild.c(277),1,43,0.04651,0,0,0.01587,0,0,0,0,0,0,0,0,0
/home/s1736883/Work/PParMetrics/benchmarks/snu-npb/nauseous-omp/DC/src/extbuild.c(262),1,24,0.08333,0,0,0.03448,0,0,0,0,0,0,0,0,0
/home/s1736883/Work/PParMetrics/benchmarks/snu-npb/nauseous-omp/DC/src/extbuild.c(328),1,124,0.129,0,0,0.04839,0.01613,0,0,9,9,0,0,0,0
/home/s1736883/Work/PParMetrics/benchmarks/snu-npb/nauseous-omp/DC/src/extbuild.c(706),0,47,0.04255,0,0,0.01307,0,0,0,0,0,0,0,0,0
/home/s1736883/Work/PParMetrics/benchmarks/snu-npb/nauseous-omp/DC/src/extbuild.c(686),0,19,0.1053,0,0,0.04255,0,0,0,0,0,0,0,0,0
/home/s1736883/Work/PParMetrics/benchmarks/snu-npb/nauseous-omp/DC/src/extbuild.c(672),0,29,0.06897,0,0,0.02198,0,0,0,0,0,0,0,0,0
/home/s1736883/Work/PParMetrics/benchmarks/snu-npb/nauseous-omp/DC/src/extbuild.c(732),0,22,0.09091,0,0,0.03636,0,0,0,0,0,0,0,0,0
/home/s1736883/Work/PParMetrics/benchmarks/snu-npb/nauseous-omp/DC/src/extbuild.c(731),0,17,0.1176,0,0,0.04878,0,0,0,0,0,0,0,0,0
/home/s1736883/Work/PParMetrics/benchmarks/snu-npb/nauseous-omp/DC/src/extbuild.c(814),1,100,0.19,1,0.2105,0.08824,0.003676,0.0625,0.0625,16,10,4,8,4,4
/home/s1736883/Work/PParMetrics/benchmarks/snu-npb/nauseous-omp/DC/src/extbuild.c(816),0,20,0.05,0,0,0.025,0,0,0,0,0,0,0,0,0
/home/s1736883/Work/PParMetrics/benchmarks/snu-npb/nauseous-omp/DC/src/extbuild.c(810),0,17,0.05882,0,0,0.02564,0,0,0,0,0,0,0,0,0
/home/s1736883/Work/PParMetrics/benchmarks/snu-npb/nauseous-omp/DC/src/extbuild.c(805),0,16,0.125,0,0,0.05405,0,0,0,0,0,0,0,0,0
/home/s1736883/Work/PParMetrics/benchmarks/snu-npb/nauseous-omp/DC/src/extbuild.c(873),1,208,0.0625,0,0,0.03696,0.02043,0,0,5,5,0,0,0,0
/home/s1736883/Work/PParMetrics/benchmarks/snu-npb/nauseous-omp/DC/src/extbuild.c(874),0,17,0.1176,0,0,0.04878,0,0,0,0,0,0,0,0,0
/home/s1736883/Work/PParMetrics/benchmarks/snu-npb/nauseous-omp/DC/src/extbuild.c(970),1,25,0.08,0,0,0.0303,0,0,0,0,0,0,0,0,0
/home/s1736883/Work/PParMetrics/benchmarks/snu-npb/nauseous-omp/DC/src/extbuild.c(980),0,21,0.5238,0,0,0.2791,0.02326,0,0,8,8,0,0,0,0
/home/s1736883/Work/PParMetrics/benchmarks/snu-npb/nauseous-omp/DC/src/jobcntl.c(27),0,19,0.2632,1,0.6,0.122,0,0,0,4,3,1,4,3,1
/home/s1736883/Work/PParMetrics/benchmarks/snu-npb/nauseous-omp/DC/src/jobcntl.c(39),0,19,0.2632,1,0.6,0.122,0,0,0,4,3,1,4,3,1
/home/s1736883/Work/PParMetrics/benchmarks/snu-npb/nauseous-omp/DC/src/jobcntl.c(51),0,16,0.5625,2,0.7778,0.25,0,0,0,11,8,3,10,7,3
/home/s1736883/Work/PParMetrics/benchmarks/snu-npb/nauseous-omp/DC/src/jobcntl.c(69),0,24,0.7083,1,0.2353,0.2391,0,0.05263,0.05263,19,11,2,6,4,2
/home/s1736883/Work/PParMetrics/benchmarks/snu-npb/nauseous-omp/DC/src/jobcntl.c(77),0,18,0.5,1,0.4444,0.2683,0.04878,0.125,0.125,8,7,1,5,4,1
/home/s1736883/Work/PParMetrics/benchmarks/snu-npb/nauseous-omp/DC/src/jobcntl.c(119),0,356,0.008427,0,0,0.001221,0.0004072,0,0,2,1,0,0,0,0
/home/s1736883/Work/PParMetrics/benchmarks/snu-npb/nauseous-omp/DC/src/jobcntl.c(124),0,175,0.96,1,0.8095,0.06504,0,0.09119,0.02736,329,154,31,293,139,31
/home/s1736883/Work/PParMetrics/benchmarks/snu-npb/nauseous-omp/DC/src/jobcntl.c(292),0,20,0.7,2,0.5,0.2381,0,0.2222,0.05556,18,11,3,10,7,3
/home/s1736883/Work/PParMetrics/benchmarks/snu-npb/nauseous-omp/DC/src/jobcntl.c(196),0,112,0.125,1,0.6429,0.06349,0.01587,0.0303,0.0303,33,19,14,28,14,14
/home/s1736883/Work/PParMetrics/benchmarks/snu-npb/nauseous-omp/DC/src/jobcntl.c(199),0,73,0.9041,1,0.7273,0.1569,0,0.1062,0.04425,113,60,11,95,49,11
/home/s1736883/Work/PParMetrics/benchmarks/snu-npb/nauseous-omp/DC/src/jobcntl.c(235),0,121,0.3223,4,0.4872,0.2,0.01538,0.04918,0.04918,61,38,22,44,22,22
/home/s1736883/Work/PParMetrics/benchmarks/snu-npb/nauseous-omp/DC/src/jobcntl.c(240),0,82,0.9146,1,0.7467,0.1395,0,0.09848,0.03788,132,68,13,113,57,13
/home/s1736883/Work/PParMetrics/benchmarks/snu-npb/nauseous-omp/DC/src/jobcntl.c(270),1,33,0.6667,0,0,0.3714,0.05714,0,0,16,16,0,0,0,0
/home/s1736883/Work/PParMetrics/benchmarks/snu-npb/nauseous-omp/DC/src/jobcntl.c(282),0,23,0.6957,1,0.25,0.2273,0,0.05556,0.05556,18,10,2,6,4,2
/home/s1736883/Work/PParMetrics/benchmarks/snu-npb/nauseous-omp/DC/src/jobcntl.c(308),0,31,0.4839,2,0.4667,0.2286,0.01429,0.2941,0.2941,17,14,3,10,7,3
/home/s1736883/Work/PParMetrics/benchmarks/snu-npb/nauseous-omp/DC/src/jobcntl.c(323),0,31,0.4839,2,0.4667,0.2286,0.01429,0.2941,0.2941,17,14,3,10,7,3
/home/s1736883/Work/PParMetrics/benchmarks/snu-npb/nauseous-omp/DC/src/jobcntl.c(340),0,40,0.825,3,0.4848,0.1744,0,0.2909,0.09091,55,30,7,24,16,7
/home/s1736883/Work/PParMetrics/benchmarks/snu-npb/nauseous-omp/DC/src/jobcntl.c(350),1,17,0.5294,0,0,0.2857,0.02857,0,0,6,6,0,0,0,0
/home/s1736883/Work/PParMetrics/benchmarks/snu-npb/nauseous-omp/DC/src/jobcntl.c(358),0,16,0.5,0,0,0.2727,0.0303,0,0,5,5,0,0,0,0
/home/s1736883/Work/PParMetrics/benchmarks/snu-npb/nauseous-omp/DC/src/jobcntl.c(373),0,112,0.04464,0,0,0.01858,0,0,0,0,0,0,0,0,0
/home/s1736883/Work/PParMetrics/benchmarks/snu-npb/nauseous-omp/DC/src/jobcntl.c(396),0,58,0.8793,2,0.3529,0.3333,0.00641,0.1609,0.1609,87,64,23,52,29,23
/home/s1736883/Work/PParMetrics/benchmarks/snu-npb/nauseous-omp/DC/src/jobcntl.c(395),0,12,0.4167,0,0,0.24,0.04,0,0,2,2,0,0,0,0
/home/s1736883/Work/PParMetrics/benchmarks/snu-npb/nauseous-omp/DC/src/jobcntl.c(407),0,21,0.6667,2,0.5,0.2273,0,0.2222,0.05556,18,11,3,10,7,3
/home/s1736883/Work/PParMetrics/benchmarks/snu-npb/nauseous-omp/DC/src/jobcntl.c(420),0,112,0.04464,0,0,0.01858,0,0,0,0,0,0,0,0,0
/home/s1736883/Work/PParMetrics/benchmarks/snu-npb/nauseous-omp/DC/src/jobcntl.c(442),0,58,0.8793,2,0.3529,0.3333,0.00641,0.1609,0.1609,87,64,23,52,29,23
/home/s1736883/Work/PParMetrics/benchmarks/snu-npb/nauseous-omp/DC/src/jobcntl.c(441),0,12,0.4167,0,0,0.24,0.04,0,0,2,2,0,0,0,0
/home/s1736883/Work/PParMetrics/benchmarks/snu-npb/nauseous-omp/DC/src/jobcntl.c(494),1,134,0.2388,1,0.4688,0.09722,0.009259,0,0,98,54,44,88,44,44
/home/s1736883/Work/PParMetrics/benchmarks/snu-npb/nauseous-omp/DC/src/jobcntl.c(496),1,38,0.6316,1,0.25,0.2979,0.04255,0.1562,0.1562,32,26,6,16,10,6
/home/s1736883/Work/PParMetrics/benchmarks/snu-npb/nauseous-omp/DC/src/jobcntl.c(503),0,60,0.7833,1,0.1489,0.3846,0.02308,0.102,0.102,49,46,3,11,8,3
/home/s1736883/Work/PParMetrics/benchmarks/snu-npb/nauseous-omp/DC/src/jobcntl.c(488),1,24,0.125,0,0,0.05882,0,0,0,0,0,0,0,0,0
/home/s1736883/Work/PParMetrics/benchmarks/snu-npb/nauseous-omp/DC/src/jobcntl.c(473),0,84,0.2143,2,0.3333,0.09953,0.01422,0.2857,0.2857,14,12,2,8,6,2
/home/s1736883/Work/PParMetrics/benchmarks/snu-npb/nauseous-omp/DC/src/jobcntl.c(471),1,19,0.4211,0,0,0.25,0.05,0,0,4,4,0,0,0,0
/home/s1736883/Work/PParMetrics/benchmarks/snu-npb/nauseous-omp/DC/src/jobcntl.c(550),1,22,0.6364,1,0.4286,0.3,0.02,0.1875,0.1875,16,14,2,9,7,2
/home/s1736883/Work/PParMetrics/benchmarks/snu-npb/nauseous-omp/DC/src/jobcntl.c(531),1,83,0.2048,1,0.2353,0.08589,0.006135,0.0625,0.0625,16,10,4,8,4,4
/home/s1736883/Work/PParMetrics/benchmarks/snu-npb/nauseous-omp/DC/src/jobcntl.c(533),0,20,0.05,0,0,0.025,0,0,0,0,0,0,0,0,0
/home/s1736883/Work/PParMetrics/benchmarks/snu-npb/nauseous-omp/DC/src/rbt.c(9),0,34,0.08824,0,0,0.0411,0,0,0,0,0,0,0,0,0
/home/s1736883/Work/PParMetrics/benchmarks/snu-npb/nauseous-omp/DC/src/rbt.c(70),0,23,0.08696,0,0,0.03333,0,0,0,0,0,0,0,0,0
/home/s1736883/Work/PParMetrics/benchmarks/snu-npb/nauseous-omp/DC/src/rbt.c(152),1,25,0.08,0,0,0.03333,0,0,0,0,0,0,0,0,0
/home/s1736883/Work/PParMetrics/benchmarks/snu-npb/nauseous-omp/DC/src/rbt.c(163),0,47,0.04255,0,0,0.01439,0,0,0,0,0,0,0,0,0
/home/s1736883/Work/PParMetrics/benchmarks/snu-npb/nauseous-omp/DC/src/rbt.c(175),0,33,0.06061,0,0,0.02299,0,0,0,0,0,0,0,0,0
/home/s1736883/Work/PParMetrics/benchmarks/snu-npb/nauseous-omp/common/randdp.c(122),0,67,0.8806,1,0.7966,0.3571,0.005952,0.08989,0.08989,89,68,21,79,58,21
/home/s1736883/Work/PParMetrics/benchmarks/snu-npb/nauseous-omp/EP/src/ep.c(285),0,14,0.4286,0,0,0.2581,0.06452,0,0,3,3,0,0,0,0
/home/s1736883/Work/PParMetrics/benchmarks/snu-npb/nauseous-omp/EP/src/ep.c(237),1,15,0.5333,1,0.375,0.2727,0.0303,0.1429,0.1429,7,6,1,4,3,1
/home/s1736883/Work/PParMetrics/benchmarks/snu-npb/nauseous-omp/EP/src/ep.c(231),1,18,0.5556,1,0.3,0.2857,0.04762,0.3,0.3,10,9,1,4,3,1
/home/s1736883/Work/PParMetrics/benchmarks/snu-npb/nauseous-omp/EP/src/ep.c(184),1,154,0.3442,4,0.4717,0.13,0.005,0.01942,0.01942,103,53,42,84,42,42
/home/s1736883/Work/PParMetrics/benchmarks/snu-npb/nauseous-omp/EP/src/ep.c(191),0,28,0.4286,0,0,0.1695,0.0339,0,0,10,6,0,0,0,0
/home/s1736883/Work/PParMetrics/benchmarks/snu-npb/nauseous-omp/EP/src/ep.c(213),0,84,0.9048,7,0.5789,0.1493,0.00995,0.2318,0.1192,151,81,22,70,42,22
/home/s1736883/Work/PParMetrics/benchmarks/snu-npb/nauseous-omp/EP/src/ep.c(179),1,12,0.4167,0,0,0.24,0.04,0,0,2,2,0,0,0,0
/home/s1736883/Work/PParMetrics/benchmarks/snu-npb/nauseous-omp/EP/src/ep.c(165),1,12,0.4167,0,0,0.24,0.04,0,0,2,2,0,0,0,0
/home/s1736883/Work/PParMetrics/benchmarks/snu-npb/nauseous-omp/EP/src/ep.c(155),0,11,0.4545,0,0,0.2381,0,0,0,2,2,0,0,0,0
/home/s1736883/Work/PParMetrics/benchmarks/snu-npb/nauseous-omp/EP/src/ep.c(132),1,12,0.4167,0,0,0.24,0.04,0,0,2,2,0,0,0,0
/home/s1736883/Work/PParMetrics/benchmarks/snu-npb/nauseous-omp/common/randdp.c(122),0,67,0.8806,1,0.7966,0.3571,0.005952,0.08989,0.08989,89,68,21,79,58,21
/home/s1736883/Work/PParMetrics/benchmarks/snu-npb/nauseous-omp/FT/src/ft.c(152),0,49,0.8367,0,0,0.3797,0.01266,0,0,30,18,0,0,0,0
/home/s1736883/Work/PParMetrics/benchmarks/snu-npb/nauseous-omp/FT/src/ft.c(134),1,10,0.3,0,0,0.1905,0.04762,0,0,0,0,0,0,0,0
/home/s1736883/Work/PParMetrics/benchmarks/snu-npb/nauseous-omp/FT/src/ft.c(120),1,10,0.3,0,0,0.1905,0.04762,0,0,0,0,0,0,0,0
/home/s1736883/Work/PParMetrics/benchmarks/snu-npb/nauseous-omp/FT/src/ft.c(200),1,85,0.1176,1,0.7,0.06061,0,0,0,20,10,10,20,10,10
/home/s1736883/Work/PParMetrics/benchmarks/snu-npb/nauseous-omp/FT/src/ft.c(201),0,74,0.1351,1,0.7,0.08696,0,0,0,20,10,10,20,10,10
/home/s1736883/Work/PParMetrics/benchmarks/snu-npb/nauseous-omp/FT/src/ft.c(202),0,63,0.8413,0,0,0.448,0.024,0,0,44,44,0,0,0,0
/home/s1736883/Work/PParMetrics/benchmarks/snu-npb/nauseous-omp/FT/src/ft.c(264),1,38,0.3158,1,0.4167,0.2,0.02222,0,0,15,9,6,12,6,6
/home/s1736883/Work/PParMetrics/benchmarks/snu-npb/nauseous-omp/FT/src/ft.c(266),0,22,0.6364,0,0,0.3333,0.02222,0,0,11,11,0,0,0,0
/home/s1736883/Work/PParMetrics/benchmarks/snu-npb/nauseous-omp/FT/src/ft.c(255),0,17,0.5294,0,0,0.2941,0.02941,0,0,5,5,0,0,0,0
/home/s1736883/Work/PParMetrics/benchmarks/snu-npb/nauseous-omp/FT/src/ft.c(553),0,54,0.4259,4,0.7826,0.2055,0,0.05263,0.05263,38,23,15,34,19,15
/home/s1736883/Work/PParMetrics/benchmarks/snu-npb/nauseous-omp/FT/src/ft.c(556),1,32,0.6875,1,0.1364,0.3529,0.02941,0.15,0.15,20,18,2,4,2,2
/home/s1736883/Work/PParMetrics/benchmarks/snu-npb/nauseous-omp/FT/src/ft.c(870),0,214,0.06542,0,0,0.04472,0.01626,0,0,8,8,0,0,0,0
/home/s1736883/Work/PParMetrics/benchmarks/snu-npb/nauseous-omp/FT/src/ft.c(599),0,39,0.2308,1,0.6667,0.1,0,0,0,16,8,8,16,8,8
/home/s1736883/Work/PParMetrics/benchmarks/snu-npb/nauseous-omp/FT/src/ft.c(600),0,28,0.6786,0,0,0.3559,0.0339,0,0,16,16,0,0,0,0
/home/s1736883/Work/PParMetrics/benchmarks/snu-npb/nauseous-omp/FT/src/ft.c(593),0,32,0.5938,0,0,0.3134,0.02985,0,0,15,15,0,0,0,0
/home/s1736883/Work/PParMetrics/benchmarks/snu-npb/nauseous-omp/common/randdp.c(122),0,67,0.8806,1,0.7966,0.3571,0.005952,0.08989,0.08989,89,68,21,79,58,21
/home/s1736883/Work/PParMetrics/benchmarks/snu-npb/nauseous-omp/IS/src/is.c(322),0,14,0.5714,2,0.75,0.2667,0,0,0,8,6,2,8,6,2
/home/s1736883/Work/PParMetrics/benchmarks/snu-npb/nauseous-omp/IS/src/is.c(317),1,14,0.5714,2,0.75,0.2667,0,0,0,8,6,2,8,6,2
/home/s1736883/Work/PParMetrics/benchmarks/snu-npb/nauseous-omp/IS/src/is.c(392),1,21,0.2381,0,0,0.09615,0,0,0,0,0,0,0,0,0
/home/s1736883/Work/PParMetrics/benchmarks/snu-npb/nauseous-omp/IS/src/is.c(495),1,12,0.4167,0,0,0.24,0.04,0,0,2,2,0,0,0,0
/home/s1736883/Work/PParMetrics/benchmarks/snu-npb/nauseous-omp/IS/src/is.c(575),1,23,0.6522,1,0.2,0.2653,0.04082,0.1875,0,16,11,1,4,3,1
/home/s1736883/Work/PParMetrics/benchmarks/snu-npb/nauseous-omp/IS/src/is.c(535),0,54,0.463,3,0.64,0.175,0.0125,0.07895,0.07895,38,22,16,32,16,16
/home/s1736883/Work/PParMetrics/benchmarks/snu-npb/nauseous-omp/IS/src/is.c(538),0,31,0.06452,0,0,0.02532,0,0,0,0,0,0,0,0,0
/home/s1736883/Work/PParMetrics/benchmarks/snu-npb/nauseous-omp/IS/src/is.c(764),0,72,0.1944,0,0,0.09494,0.006329,0,0,1,1,0,0,0,0
/home/s1736883/Work/PParMetrics/benchmarks/snu-npb/nauseous-omp/IS/src/is.c(693),0,105,0.5524,4,0.6897,0.1321,0.007143,0.04206,0.04206,214,118,96,197,101,96
/home/s1736883/Work/PParMetrics/benchmarks/snu-npb/nauseous-omp/IS/src/is.c(698),0,14,0.4286,0,0,0.2414,0.03448,0,0,3,3,0,0,0,0
/home/s1736883/Work/PParMetrics/benchmarks/snu-npb/nauseous-omp/IS/src/is.c(707),0,23,0.08696,0,0,0.03704,0,0,0,0,0,0,0,0,0
/home/s1736883/Work/PParMetrics/benchmarks/snu-npb/nauseous-omp/IS/src/is.c(715),0,22,0.5909,1,0.3077,0.2885,0.03846,0.2,0.2,15,13,2,7,5,2
/home/s1736883/Work/PParMetrics/benchmarks/snu-npb/nauseous-omp/IS/src/is.c(669),1,25,0.72,2,0.3333,0.3333,0.01754,0.2857,0.2857,21,18,3,8,5,3
/home/s1736883/Work/PParMetrics/benchmarks/snu-npb/nauseous-omp/IS/src/is.c(658),0,71,0.3239,2,0.8696,0.07092,0.02128,0.02128,0.02128,94,49,45,91,46,45
/home/s1736883/Work/PParMetrics/benchmarks/snu-npb/nauseous-omp/IS/src/is.c(649),1,20,0.65,1,0.5385,0.3043,0.02174,0.2,0.2,15,13,2,11,9,2
/home/s1736883/Work/PParMetrics/benchmarks/snu-npb/nauseous-omp/IS/src/is.c(644),0,13,0.4615,0,0,0.2593,0.03704,0,0,3,3,0,0,0,0
/home/s1736883/Work/PParMetrics/benchmarks/snu-npb/nauseous-omp/IS/src/is.c(612),1,19,0.5789,0,0,0.3171,0.04878,0,0,8,8,0,0,0,0
/home/s1736883/Work/PParMetrics/benchmarks/snu-npb/nauseous-omp/IS/src/is.c(987),0,12,0.3333,0,0,0.2308,0.07692,0,0,0,0,0,0,0,0
/home/s1736883/Work/PParMetrics/benchmarks/snu-npb/nauseous-omp/IS/src/is.c(922),1,24,0.5833,0,0,0.3333,0.07407,0,0,10,10,0,0,0,0
/home/s1736883/Work/PParMetrics/benchmarks/snu-npb/nauseous-omp/LU/src/blts.c(85),1,1185,0.04135,1,0.9184,0.0005409,0,0.00578,0.00578,173,87,86,172,86,86
/home/s1736883/Work/PParMetrics/benchmarks/snu-npb/nauseous-omp/LU/src/blts.c(86),0,1173,0.7144,2,0.5883,0.07405,0.00142,0.01986,0.01986,9666,5182,4484,9325,4841,4484
/home/s1736883/Work/PParMetrics/benchmarks/snu-npb/nauseous-omp/LU/src/blts.c(87),1,286,0.9371,1,0.1604,0.4396,0.01884,0.07492,0.07492,307,286,21,84,63,21
/home/s1736883/Work/PParMetrics/benchmarks/snu-npb/nauseous-omp/LU/src/blts.c(106),1,98,0.8367,1,0.122,0.3525,0.03831,0.08,0.08,125,100,25,55,30,25
/home/s1736883/Work/PParMetrics/benchmarks/snu-npb/nauseous-omp/LU/src/blts.c(70),1,182,0.1099,1,0.8,0.03049,0,0.01754,0.01754,57,29,28,56,28,28
/home/s1736883/Work/PParMetrics/benchmarks/snu-npb/nauseous-omp/LU/src/blts.c(71),0,170,0,0,0,0,0,0,0,0,0,0,0,0,0
/home/s1736883/Work/PParMetrics/benchmarks/snu-npb/nauseous-omp/LU/src/blts.c(72),0,159,0.9182,1,0.2123,0.4286,0.01961,0.1006,0.1006,169,156,13,56,43,13
/home/s1736883/Work/PParMetrics/benchmarks/snu-npb/nauseous-omp/LU/src/buts.c(82),1,1793,0.05856,1,0.9905,0.0001247,4.16E-05,0.002445,0.002445,409,205,204,408,204,204
/home/s1736883/Work/PParMetrics/benchmarks/snu-npb/nauseous-omp/LU/src/buts.c(83),0,1780,0.568,1,0.7181,0.04772,0.01086,0.008374,0.008374,24121,12510,11611,23836,12225,11611
/home/s1736883/Work/PParMetrics/benchmarks/snu-npb/nauseous-omp/LU/src/buts.c(84),0,344,0.9477,1,0.3098,0.435,0.01544,0.1208,0.1208,389,356,33,166,133,33
/home/s1736883/Work/PParMetrics/benchmarks/snu-npb/nauseous-omp/LU/src/buts.c(101),1,98,0.8367,1,0.122,0.3525,0.03831,0.08,0.08,125,100,25,55,30,25
/home/s1736883/Work/PParMetrics/benchmarks/snu-npb/nauseous-omp/LU/src/buts.c(68),1,200,0.08,1,0.9375,0.01852,0.006173,0.01887,0.01887,53,27,26,52,26,26
/home/s1736883/Work/PParMetrics/benchmarks/snu-npb/nauseous-omp/LU/src/buts.c(69),0,187,0,0,0,0,0,0,0,0,0,0,0,0,0
/home/s1736883/Work/PParMetrics/benchmarks/snu-npb/nauseous-omp/LU/src/buts.c(70),0,176,0.9318,1,0.3049,0.4304,0.01519,0.1244,0.1244,193,177,16,81,65,16
/home/s1736883/Work/PParMetrics/benchmarks/snu-npb/nauseous-omp/LU/src/erhs.c(342),1,1398,0.0608,1,1,0.0005804,0.0002902,0,0,332,166,166,332,166,166
/home/s1736883/Work/PParMetrics/benchmarks/snu-npb/nauseous-omp/LU/src/erhs.c(343),0,1386,0,0,0,0,0,0,0,0,0,0,0,0,0
/home/s1736883/Work/PParMetrics/benchmarks/snu-npb/nauseous-omp/LU/src/erhs.c(344),1,225,0.88,2,0.0404,0.4404,0.0404,0.0398,0.0398,201,195,6,12,6,6
/home/s1736883/Work/PParMetrics/benchmarks/snu-npb/nauseous-omp/LU/src/erhs.c(357),1,66,0.1667,1,0.7273,0.07143,0,0,0,24,12,12,24,12,12
/home/s1736883/Work/PParMetrics/benchmarks/snu-npb/nauseous-omp/LU/src/erhs.c(364),1,232,0.9095,9,0.1991,0.4032,0.02509,0.1527,0.1527,275,235,40,80,40,40
/home/s1736883/Work/PParMetrics/benchmarks/snu-npb/nauseous-omp/LU/src/erhs.c(390),1,403,0.8983,1,0.05249,0.4308,0.03599,0.04691,0.04691,405,380,25,64,39,25
/home/s1736883/Work/PParMetrics/benchmarks/snu-npb/nauseous-omp/LU/src/erhs.c(420),1,134,0.8731,1,0.05128,0.4324,0.03716,0.04959,0.04959,121,117,4,12,8,4
/home/s1736883/Work/PParMetrics/benchmarks/snu-npb/nauseous-omp/LU/src/erhs.c(432),1,125,0.112,1,0.7857,0.05405,0,0,0,36,18,18,36,18,18
/home/s1736883/Work/PParMetrics/benchmarks/snu-npb/nauseous-omp/LU/src/erhs.c(443),1,178,0.9045,1,0.03727,0.4479,0.02865,0.03636,0.03636,165,161,4,12,8,4
/home/s1736883/Work/PParMetrics/benchmarks/snu-npb/nauseous-omp/LU/src/erhs.c(358),1,54,0.8148,1,0.06818,0.4103,0.03419,0.06977,0.06977,43,42,1,4,3,1
/home/s1736883/Work/PParMetrics/benchmarks/snu-npb/nauseous-omp/LU/src/erhs.c(433),1,113,0.885,1,0.03,0.444,0.02905,0.0303,0.0303,99,98,1,4,3,1
/home/s1736883/Work/PParMetrics/benchmarks/snu-npb/nauseous-omp/LU/src/erhs.c(223),1,1411,0.06024,1,1,0.00058,0.00029,0,0,332,166,166,332,166,166
/home/s1736883/Work/PParMetrics/benchmarks/snu-npb/nauseous-omp/LU/src/erhs.c(224),0,1398,0.0701,1,1,0.002556,0.0009585,0,0,1760,880,880,1760,880,880
/home/s1736883/Work/PParMetrics/benchmarks/snu-npb/nauseous-omp/LU/src/erhs.c(225),1,225,0.88,2,0.0404,0.4404,0.0404,0.0398,0.0398,201,195,6,12,6,6
/home/s1736883/Work/PParMetrics/benchmarks/snu-npb/nauseous-omp/LU/src/erhs.c(238),1,65,0,0,0,0,0,0,0,0,0,0,0,0,0
/home/s1736883/Work/PParMetrics/benchmarks/snu-npb/nauseous-omp/LU/src/erhs.c(245),1,232,0.9095,9,0.1991,0.4032,0.02509,0.1527,0.1527,275,235,40,80,40,40
/home/s1736883/Work/PParMetrics/benchmarks/snu-npb/nauseous-omp/LU/src/erhs.c(271),1,402,0.9005,1,0.05249,0.4317,0.03607,0.04691,0.04691,405,380,25,64,39,25
/home/s1736883/Work/PParMetrics/benchmarks/snu-npb/nauseous-omp/LU/src/erhs.c(301),1,145,0.8828,1,0.04688,0.4371,0.03459,0.04545,0.04545,132,128,4,12,8,4
/home/s1736883/Work/PParMetrics/benchmarks/snu-npb/nauseous-omp/LU/src/erhs.c(313),1,125,0,0,0,0,0,0,0,0,0,0,0,0,0
/home/s1736883/Work/PParMetrics/benchmarks/snu-npb/nauseous-omp/LU/src/erhs.c(324),1,178,0.9045,1,0.03727,0.4479,0.02865,0.03636,0.03636,165,161,4,12,8,4
/home/s1736883/Work/PParMetrics/benchmarks/snu-npb/nauseous-omp/LU/src/erhs.c(239),1,54,0.8148,1,0.06818,0.4103,0.03419,0.06977,0.06977,43,42,1,4,3,1
/home/s1736883/Work/PParMetrics/benchmarks/snu-npb/nauseous-omp/LU/src/erhs.c(314),1,113,0.885,1,0.03,0.444,0.02905,0.0303,0.0303,99,98,1,4,3,1
/home/s1736883/Work/PParMetrics/benchmarks/snu-npb/nauseous-omp/LU/src/erhs.c(105),1,1411,0.06024,1,1,0.00058,0.00029,0,0,332,166,166,332,166,166
/home/s1736883/Work/PParMetrics/benchmarks/snu-npb/nauseous-omp/LU/src/erhs.c(106),0,1398,0.0701,1,1,0.002556,0.0009585,0,0,1760,880,880,1760,880,880
/home/s1736883/Work/PParMetrics/benchmarks/snu-npb/nauseous-omp/LU/src/erhs.c(107),1,225,0.88,2,0.0404,0.4404,0.0404,0.0398,0.0398,201,195,6,12,6,6
/home/s1736883/Work/PParMetrics/benchmarks/snu-npb/nauseous-omp/LU/src/erhs.c(120),1,65,0,0,0,0,0,0,0,0,0,0,0,0,0
/home/s1736883/Work/PParMetrics/benchmarks/snu-npb/nauseous-omp/LU/src/erhs.c(126),1,232,0.9095,9,0.1991,0.4032,0.02509,0.1527,0.1527,275,235,40,80,40,40
/home/s1736883/Work/PParMetrics/benchmarks/snu-npb/nauseous-omp/LU/src/erhs.c(152),1,402,0.9005,1,0.05249,0.4317,0.03607,0.04691,0.04691,405,380,25,64,39,25
/home/s1736883/Work/PParMetrics/benchmarks/snu-npb/nauseous-omp/LU/src/erhs.c(182),1,145,0.8828,1,0.04688,0.4371,0.03459,0.04545,0.04545,132,128,4,12,8,4
/home/s1736883/Work/PParMetrics/benchmarks/snu-npb/nauseous-omp/LU/src/erhs.c(194),1,125,0,0,0,0,0,0,0,0,0,0,0,0,0
/home/s1736883/Work/PParMetrics/benchmarks/snu-npb/nauseous-omp/LU/src/erhs.c(205),1,178,0.9045,1,0.03727,0.4479,0.02865,0.03636,0.03636,165,161,4,12,8,4
/home/s1736883/Work/PParMetrics/benchmarks/snu-npb/nauseous-omp/LU/src/erhs.c(121),1,54,0.8148,1,0.06818,0.4103,0.03419,0.06977,0.06977,43,42,1,4,3,1
/home/s1736883/Work/PParMetrics/benchmarks/snu-npb/nauseous-omp/LU/src/erhs.c(195),1,113,0.885,1,0.03,0.444,0.02905,0.0303,0.0303,99,98,1,4,3,1
/home/s1736883/Work/PParMetrics/benchmarks/snu-npb/nauseous-omp/LU/src/erhs.c(76),1,176,0.04545,1,0.625,0.03822,0.01274,0.09091,0.09091,11,7,4,8,4,4
/home/s1736883/Work/PParMetrics/benchmarks/snu-npb/nauseous-omp/LU/src/erhs.c(78),1,158,0.1203,2,0.5789,0.08271,0.007519,0.03448,0.03448,29,17,12,24,12,12
/home/s1736883/Work/PParMetrics/benchmarks/snu-npb/nauseous-omp/LU/src/erhs.c(80),1,140,0.2214,2,0.7419,0.1009,0.009174,0.01299,0.01299,77,41,36,72,36,36
/home/s1736883/Work/PParMetrics/benchmarks/snu-npb/nauseous-omp/LU/src/erhs.c(82),1,122,0.8361,0,0,0.428,0.05166,0,0,99,99,0,0,0,0
/home/s1736883/Work/PParMetrics/benchmarks/snu-npb/nauseous-omp/LU/src/erhs.c(65),1,54,0.1481,1,0.625,0.06897,0,0,0,12,6,6,12,6,6
/home/s1736883/Work/PParMetrics/benchmarks/snu-npb/nauseous-omp/LU/src/erhs.c(66),1,43,0,0,0,0,0,0,0,0,0,0,0,0,0
/home/s1736883/Work/PParMetrics/benchmarks/snu-npb/nauseous-omp/LU/src/erhs.c(67),1,32,0.25,1,0.625,0.1176,0,0,0,12,6,6,12,6,6
/home/s1736883/Work/PParMetrics/benchmarks/snu-npb/nauseous-omp/LU/src/erhs.c(68),1,21,0.6667,0,0,0.3488,0.02326,0,0,11,11,0,0,0,0
/home/s1736883/Work/PParMetrics/benchmarks/snu-npb/nauseous-omp/LU/src/error.c(81),1,27,0.7037,1,0.2105,0.3559,0.0339,0.1667,0.1667,18,17,1,5,4,1
/home/s1736883/Work/PParMetrics/benchmarks/snu-npb/nauseous-omp/LU/src/error.c(75),1,18,0.5556,1,0.3,0.2857,0.04762,0.3,0.3,10,9,1,4,3,1
/home/s1736883/Work/PParMetrics/benchmarks/snu-npb/nauseous-omp/LU/src/error.c(64),1,80,0.125,1,0.6,0.05556,0,0.05882,0.05882,17,9,8,16,8,8
/home/s1736883/Work/PParMetrics/benchmarks/snu-npb/nauseous-omp/LU/src/error.c(65),0,67,0.08955,1,1,0.02778,0.01389,0,0,16,8,8,16,8,8
/home/s1736883/Work/PParMetrics/benchmarks/snu-npb/nauseous-omp/LU/src/error.c(66),0,55,0.2727,1,0.5333,0.1429,0.01587,0,0,27,15,12,24,12,12
/home/s1736883/Work/PParMetrics/benchmarks/snu-npb/nauseous-omp/LU/src/error.c(68),0,39,0.7436,2,0.2069,0.3667,0.04444,0.1935,0.1935,31,28,3,8,5,3
/home/s1736883/Work/PParMetrics/benchmarks/snu-npb/nauseous-omp/LU/src/error.c(60),1,12,0.4167,0,0,0.24,0.04,0,0,2,2,0,0,0,0
/home/s1736883/Work/PParMetrics/benchmarks/snu-npb/nauseous-omp/LU/src/error.c(54),1,12,0.4167,0,0,0.24,0.04,0,0,2,2,0,0,0,0
/home/s1736883/Work/PParMetrics/benchmarks/snu-npb/nauseous-omp/LU/src/exact.c(54),0,114,0.8246,1,0.4043,0.3843,0.04982,0.2222,0.2222,117,104,13,63,50,13
/home/s1736883/Work/PParMetrics/benchmarks/snu-npb/nauseous-omp/LU/src/jacld.c(56),1,3818,0.06234,1,1,0.0008163,0.0004082,0,0,944,472,472,944,472,472
/home/s1736883/Work/PParMetrics/benchmarks/snu-npb/nauseous-omp/LU/src/jacld.c(57),1,3806,0.9367,3,0.03899,0.4229,0.02605,0.03112,0.03112,4467,3959,508,1016,508,508
/home/s1736883/Work/PParMetrics/benchmarks/snu-npb/nauseous-omp/LU/src/jacu.c(56),1,3768,0.06343,1,0.9958,0.001223,0.0004078,0.001058,0.001058,945,473,472,944,472,472
/home/s1736883/Work/PParMetrics/benchmarks/snu-npb/nauseous-omp/LU/src/jacu.c(57),1,3755,0.9358,3,0.03956,0.422,0.02635,0.03148,0.03148,4416,3908,508,1016,508,508
/home/s1736883/Work/PParMetrics/benchmarks/snu-npb/nauseous-omp/LU/src/l2norm.c(80),1,29,0.7241,1,0.1905,0.3651,0.03175,0.15,0.15,20,19,1,5,4,1
/home/s1736883/Work/PParMetrics/benchmarks/snu-npb/nauseous-omp/LU/src/l2norm.c(74),1,19,0.5789,1,0.2727,0.2955,0.04545,0.2727,0.2727,11,10,1,4,3,1
/home/s1736883/Work/PParMetrics/benchmarks/snu-npb/nauseous-omp/LU/src/l2norm.c(65),1,88,0.1136,1,0.6,0.05814,0,0.05882,0.05882,17,9,8,16,8,8
/home/s1736883/Work/PParMetrics/benchmarks/snu-npb/nauseous-omp/LU/src/l2norm.c(66),0,75,0.1333,1,0.6,0.07353,0,0.05882,0.05882,17,9,8,16,8,8
/home/s1736883/Work/PParMetrics/benchmarks/snu-npb/nauseous-omp/LU/src/l2norm.c(67),0,63,0.1746,1,0.7273,0.08,0,0,0,24,12,12,24,12,12
/home/s1736883/Work/PParMetrics/benchmarks/snu-npb/nauseous-omp/LU/src/l2norm.c(68),1,52,0.8077,1,0.07143,0.4071,0.0354,0.07317,0.07317,41,40,1,4,3,1
/home/s1736883/Work/PParMetrics/benchmarks/snu-npb/nauseous-omp/LU/src/l2norm.c(61),1,12,0.4167,0,0,0.24,0.04,0,0,2,2,0,0,0,0
/home/s1736883/Work/PParMetrics/benchmarks/snu-npb/nauseous-omp/LU/src/l2norm.c(55),1,13,0.4615,0,0,0.2593,0.03704,0,0,3,3,0,0,0,0
/home/s1736883/Work/PParMetrics/benchmarks/snu-npb/nauseous-omp/LU/src/lu.c(253),0,56,0.7679,1,0.186,0.3481,0.02963,0.1091,0.1091,55,45,10,22,12,10
/home/s1736883/Work/PParMetrics/benchmarks/snu-npb/nauseous-omp/LU/src/lu.c(246),1,14,0.4286,0,0,0.2581,0.06452,0,0,3,3,0,0,0,0
/home/s1736883/Work/PParMetrics/benchmarks/snu-npb/nauseous-omp/LU/src/pintgr.c(172),1,96,0.125,1,1,0.02439,0.0122,0,0,40,20,20,40,20,20
/home/s1736883/Work/PParMetrics/benchmarks/snu-npb/nauseous-omp/LU/src/pintgr.c(173),1,83,0.8193,1,0.04412,0.4153,0.04372,0.01493,0.01493,67,66,1,4,3,1
/home/s1736883/Work/PParMetrics/benchmarks/snu-npb/nauseous-omp/LU/src/pintgr.c(158),1,133,0.09774,1,1,0.02381,0.0119,0,0,44,22,22,44,22,22
/home/s1736883/Work/PParMetrics/benchmarks/snu-npb/nauseous-omp/LU/src/pintgr.c(159),1,121,0.8678,0,0,0.4402,0.03475,0,0,102,102,0,0,0,0
/home/s1736883/Work/PParMetrics/benchmarks/snu-npb/nauseous-omp/LU/src/pintgr.c(147),1,125,0.104,1,1,0.02381,0.0119,0,0,44,22,22,44,22,22
/home/s1736883/Work/PParMetrics/benchmarks/snu-npb/nauseous-omp/LU/src/pintgr.c(148),1,113,0.8584,0,0,0.4362,0.03704,0,0,94,94,0,0,0,0
/home/s1736883/Work/PParMetrics/benchmarks/snu-npb/nauseous-omp/LU/src/pintgr.c(130),1,96,0.125,1,1,0.02439,0.0122,0,0,40,20,20,40,20,20
/home/s1736883/Work/PParMetrics/benchmarks/snu-npb/nauseous-omp/LU/src/pintgr.c(131),1,83,0.8193,1,0.04412,0.4153,0.04372,0.01493,0.01493,67,66,1,4,3,1
/home/s1736883/Work/PParMetrics/benchmarks/snu-npb/nauseous-omp/LU/src/pintgr.c(116),1,133,0.09774,1,1,0.02381,0.0119,0,0,44,22,22,44,22,22
/home/s1736883/Work/PParMetrics/benchmarks/snu-npb/nauseous-omp/LU/src/pintgr.c(117),1,121,0.8678,0,0,0.4402,0.03475,0,0,102,102,0,0,0,0
/home/s1736883/Work/PParMetrics/benchmarks/snu-npb/nauseous-omp/LU/src/pintgr.c(105),1,125,0.104,1,1,0.02381,0.0119,0,0,44,22,22,44,22,22
/home/s1736883/Work/PParMetrics/benchmarks/snu-npb/nauseous-omp/LU/src/pintgr.c(106),1,113,0.8584,0,0,0.4362,0.03704,0,0,94,94,0,0,0,0
/home/s1736883/Work/PParMetrics/benchmarks/snu-npb/nauseous-omp/LU/src/pintgr.c(88),1,95,0.1684,1,0.75,0.0625,0,0.02439,0.02439,41,21,20,40,20,20
/home/s1736883/Work/PParMetrics/benchmarks/snu-npb/nauseous-omp/LU/src/pintgr.c(89),1,83,0.8193,1,0.04412,0.4153,0.04372,0.01493,0.01493,67,66,1,4,3,1
/home/s1736883/Work/PParMetrics/benchmarks/snu-npb/nauseous-omp/LU/src/pintgr.c(64),1,234,0.09402,1,1,0.009901,0.00495,0,0,80,40,40,80,40,40
/home/s1736883/Work/PParMetrics/benchmarks/snu-npb/nauseous-omp/LU/src/pintgr.c(65),1,222,0.8874,1,0.09137,0.3981,0.03333,0.07059,0.07059,255,223,32,64,32,32
/home/s1736883/Work/PParMetrics/benchmarks/snu-npb/nauseous-omp/LU/src/read_input.c(88),0,5,0.2,0,0,0.125,0,0,0,0,0,0,0,0,0
/home/s1736883/Work/PParMetrics/benchmarks/snu-npb/nauseous-omp/LU/src/read_input.c(87),0,5,0.2,0,0,0.125,0,0,0,0,0,0,0,0,0
/home/s1736883/Work/PParMetrics/benchmarks/snu-npb/nauseous-omp/LU/src/read_input.c(84),0,5,0.2,0,0,0.125,0,0,0,0,0,0,0,0,0
/home/s1736883/Work/PParMetrics/benchmarks/snu-npb/nauseous-omp/LU/src/read_input.c(83),0,5,0.2,0,0,0.125,0,0,0,0,0,0,0,0,0
/home/s1736883/Work/PParMetrics/benchmarks/snu-npb/nauseous-omp/LU/src/read_input.c(81),0,5,0.2,0,0,0.125,0,0,0,0,0,0,0,0,0
/home/s1736883/Work/PParMetrics/benchmarks/snu-npb/nauseous-omp/LU/src/read_input.c(79),0,5,0.2,0,0,0.125,0,0,0,0,0,0,0,0,0
/home/s1736883/Work/PParMetrics/benchmarks/snu-npb/nauseous-omp/LU/src/read_input.c(78),0,5,0.2,0,0,0.125,0,0,0,0,0,0,0,0,0
/home/s1736883/Work/PParMetrics/benchmarks/snu-npb/nauseous-omp/LU/src/read_input.c(76),0,5,0.2,0,0,0.125,0,0,0,0,0,0,0,0,0
/home/s1736883/Work/PParMetrics/benchmarks/snu-npb/nauseous-omp/LU/src/read_input.c(74),0,5,0.2,0,0,0.125,0,0,0,0,0,0,0,0,0
/home/s1736883/Work/PParMetrics/benchmarks/snu-npb/nauseous-omp/LU/src/read_input.c(73),0,5,0.2,0,0,0.125,0,0,0,0,0,0,0,0,0
/home/s1736883/Work/PParMetrics/benchmarks/snu-npb/nauseous-omp/LU/src/read_input.c(71),0,5,0.2,0,0,0.125,0,0,0,0,0,0,0,0,0
/home/s1736883/Work/PParMetrics/benchmarks/snu-npb/nauseous-omp/LU/src/read_input.c(69),0,5,0.2,0,0,0.125,0,0,0,0,0,0,0,0,0
/home/s1736883/Work/PParMetrics/benchmarks/snu-npb/nauseous-omp/LU/src/read_input.c(68),0,5,0.2,0,0,0.125,0,0,0,0,0,0,0,0,0
/home/s1736883/Work/PParMetrics/benchmarks/snu-npb/nauseous-omp/LU/src/read_input.c(66),0,5,0.2,0,0,0.125,0,0,0,0,0,0,0,0,0
/home/s1736883/Work/PParMetrics/benchmarks/snu-npb/nauseous-omp/LU/src/read_input.c(64),0,5,0.2,0,0,0.125,0,0,0,0,0,0,0,0,0
/home/s1736883/Work/PParMetrics/benchmarks/snu-npb/nauseous-omp/LU/src/read_input.c(63),0,5,0.2,0,0,0.125,0,0,0,0,0,0,0,0,0
/home/s1736883/Work/PParMetrics/benchmarks/snu-npb/nauseous-omp/LU/src/rhs.c(344),1,1029,0.01652,1,1,0.0004885,0.0002443,0,0,60,30,30,60,30,30
/home/s1736883/Work/PParMetrics/benchmarks/snu-npb/nauseous-omp/LU/src/rhs.c(345),0,1017,0,0,0,0,0,0,0,0,0,0,0,0,0
/home/s1736883/Work/PParMetrics/benchmarks/snu-npb/nauseous-omp/LU/src/rhs.c(346),1,104,0.8173,0,0,0.4292,0.0531,0,0,77,77,0,0,0,0
/home/s1736883/Work/PParMetrics/benchmarks/snu-npb/nauseous-omp/LU/src/rhs.c(354),1,103,0.7961,2,0.09756,0.4017,0.05858,0.09412,0.09412,85,79,6,12,6,6
/home/s1736883/Work/PParMetrics/benchmarks/snu-npb/nauseous-omp/LU/src/rhs.c(366),1,60,0,0,0,0,0,0,0,0,0,0,0,0,0
/home/s1736883/Work/PParMetrics/benchmarks/snu-npb/nauseous-omp/LU/src/rhs.c(373),1,170,0.8765,9,0.2819,0.3756,0.03226,0.1972,0.1972,213,173,40,80,40,40
/home/s1736883/Work/PParMetrics/benchmarks/snu-npb/nauseous-omp/LU/src/rhs.c(399),1,253,0.8379,1,0.08962,0.3971,0.05348,0.07451,0.07451,255,230,25,64,39,25
/home/s1736883/Work/PParMetrics/benchmarks/snu-npb/nauseous-omp/LU/src/rhs.c(429),1,89,0.809,0,0,0.4192,0.05556,0,0,68,68,0,0,0,0
/home/s1736883/Work/PParMetrics/benchmarks/snu-npb/nauseous-omp/LU/src/rhs.c(441),1,89,0,0,0,0,0,0,0,0,0,0,0,0,0
/home/s1736883/Work/PParMetrics/benchmarks/snu-npb/nauseous-omp/LU/src/rhs.c(452),1,124,0.8629,0,0,0.4403,0.04104,0,0,103,103,0,0,0,0
/home/s1736883/Work/PParMetrics/benchmarks/snu-npb/nauseous-omp/LU/src/rhs.c(367),1,48,0.7917,0,0,0.4078,0.03883,0,0,35,35,0,0,0,0
/home/s1736883/Work/PParMetrics/benchmarks/snu-npb/nauseous-omp/LU/src/rhs.c(442),1,77,0.8312,0,0,0.4251,0.04192,0,0,61,61,0,0,0,0
/home/s1736883/Work/PParMetrics/benchmarks/snu-npb/nauseous-omp/LU/src/rhs.c(211),1,1368,0.06652,1,1,0.001388,0.0006941,0,0,1328,664,664,1328,664,664
/home/s1736883/Work/PParMetrics/benchmarks/snu-npb/nauseous-omp/LU/src/rhs.c(212),0,865,0.09364,1,1,0.004217,0.001807,0,0,1168,584,584,1168,584,584
/home/s1736883/Work/PParMetrics/benchmarks/snu-npb/nauseous-omp/LU/src/rhs.c(292),1,156,0,0,0,0,0,0,0,0,0,0,0,0,0
/home/s1736883/Work/PParMetrics/benchmarks/snu-npb/nauseous-omp/LU/src/rhs.c(306),1,137,0.1095,1,0.7333,0.04464,0,0.02703,0.02703,37,19,18,36,18,18
/home/s1736883/Work/PParMetrics/benchmarks/snu-npb/nauseous-omp/LU/src/rhs.c(319),1,189,0.09524,1,0.8333,0.03922,0,0,0,52,26,26,52,26,26
/home/s1736883/Work/PParMetrics/benchmarks/snu-npb/nauseous-omp/LU/src/rhs.c(213),1,150,0.86,2,0.06202,0.4294,0.04204,0.06061,0.06061,132,126,6,12,6,6
/home/s1736883/Work/PParMetrics/benchmarks/snu-npb/nauseous-omp/LU/src/rhs.c(225),1,65,0,0,0,0,0,0,0,0,0,0,0,0,0
/home/s1736883/Work/PParMetrics/benchmarks/snu-npb/nauseous-omp/LU/src/rhs.c(232),1,228,0.9079,9,0.2029,0.4018,0.02545,0.155,0.155,271,231,40,80,40,40
/home/s1736883/Work/PParMetrics/benchmarks/snu-npb/nauseous-omp/LU/src/rhs.c(257),1,402,0.9005,1,0.05249,0.4317,0.03607,0.04691,0.04691,405,380,25,64,39,25
/home/s1736883/Work/PParMetrics/benchmarks/snu-npb/nauseous-omp/LU/src/rhs.c(293),1,145,0.8828,1,0.04688,0.4371,0.03459,0.04545,0.04545,132,128,4,12,8,4
/home/s1736883/Work/PParMetrics/benchmarks/snu-npb/nauseous-omp/LU/src/rhs.c(307),1,124,0,0,0,0,0,0,0,0,0,0,0,0,0
/home/s1736883/Work/PParMetrics/benchmarks/snu-npb/nauseous-omp/LU/src/rhs.c(320),1,178,0.9045,1,0.03727,0.4479,0.02865,0.03636,0.03636,165,161,4,12,8,4
/home/s1736883/Work/PParMetrics/benchmarks/snu-npb/nauseous-omp/LU/src/rhs.c(226),1,54,0.8148,1,0.06818,0.4103,0.03419,0.06977,0.06977,43,42,1,4,3,1
/home/s1736883/Work/PParMetrics/benchmarks/snu-npb/nauseous-omp/LU/src/rhs.c(308),1,113,0.885,1,0.03,0.444,0.02905,0.0303,0.0303,99,98,1,4,3,1
/home/s1736883/Work/PParMetrics/benchmarks/snu-npb/nauseous-omp/LU/src/rhs.c(86),1,1332,0.05931,1,1,0.0006075,0.0003038,0,0,308,154,154,308,154,154
/home/s1736883/Work/PParMetrics/benchmarks/snu-npb/nauseous-omp/LU/src/rhs.c(87),0,1319,0.06975,1,1,0.002668,0.001001,0,0,1640,820,820,1640,820,820
/home/s1736883/Work/PParMetrics/benchmarks/snu-npb/nauseous-omp/LU/src/rhs.c(88),1,150,0.86,2,0.06202,0.4294,0.04204,0.06061,0.06061,132,126,6,12,6,6
/home/s1736883/Work/PParMetrics/benchmarks/snu-npb/nauseous-omp/LU/src/rhs.c(100),1,65,0,0,0,0,0,0,0,0,0,0,0,0,0
/home/s1736883/Work/PParMetrics/benchmarks/snu-npb/nauseous-omp/LU/src/rhs.c(107),1,228,0.9079,9,0.2029,0.4018,0.02545,0.155,0.155,271,231,40,80,40,40
/home/s1736883/Work/PParMetrics/benchmarks/snu-npb/nauseous-omp/LU/src/rhs.c(133),1,402,0.9005,1,0.05249,0.4317,0.03607,0.04691,0.04691,405,380,25,64,39,25
/home/s1736883/Work/PParMetrics/benchmarks/snu-npb/nauseous-omp/LU/src/rhs.c(163),1,145,0.8828,1,0.04688,0.4371,0.03459,0.04545,0.04545,132,128,4,12,8,4
/home/s1736883/Work/PParMetrics/benchmarks/snu-npb/nauseous-omp/LU/src/rhs.c(175),1,125,0,0,0,0,0,0,0,0,0,0,0,0,0
/home/s1736883/Work/PParMetrics/benchmarks/snu-npb/nauseous-omp/LU/src/rhs.c(187),1,178,0.9045,1,0.03727,0.4479,0.02865,0.03636,0.03636,165,161,4,12,8,4
/home/s1736883/Work/PParMetrics/benchmarks/snu-npb/nauseous-omp/LU/src/rhs.c(101),1,54,0.8148,1,0.06818,0.4103,0.03419,0.06977,0.06977,43,42,1,4,3,1
/home/s1736883/Work/PParMetrics/benchmarks/snu-npb/nauseous-omp/LU/src/rhs.c(176),1,113,0.885,1,0.03,0.444,0.02905,0.0303,0.0303,99,98,1,4,3,1
/home/s1736883/Work/PParMetrics/benchmarks/snu-npb/nauseous-omp/LU/src/rhs.c(64),1,176,0,0,0,0,0,0,0,0,0,0,0,0,0
/home/s1736883/Work/PParMetrics/benchmarks/snu-npb/nauseous-omp/LU/src/rhs.c(65),1,165,0,0,0,0,0,0,0,0,0,0,0,0,0
/home/s1736883/Work/PParMetrics/benchmarks/snu-npb/nauseous-omp/LU/src/rhs.c(66),1,154,0.7013,2,0.08333,0.4073,0.03273,0.02586,0.02586,116,106,10,20,10,10
/home/s1736883/Work/PParMetrics/benchmarks/snu-npb/nauseous-omp/LU/src/rhs.c(67),1,35,0.7714,0,0,0.3973,0.0274,0,0,24,24,0,0,0,0
/home/s1736883/Work/PParMetrics/benchmarks/snu-npb/nauseous-omp/LU/src/setbv.c(85),1,73,0.1507,1,0.7273,0.05263,0,0,0,24,12,12,24,12,12
/home/s1736883/Work/PParMetrics/benchmarks/snu-npb/nauseous-omp/LU/src/setbv.c(86),1,62,0.04839,0,0,0.1429,0.1,0,0,1,1,0,0,0,0
/home/s1736883/Work/PParMetrics/benchmarks/snu-npb/nauseous-omp/LU/src/setbv.c(89),0,41,0.7561,0,0,0.3977,0.04545,0,0,27,27,0,0,0,0
/home/s1736883/Work/PParMetrics/benchmarks/snu-npb/nauseous-omp/LU/src/setbv.c(70),1,73,0,0,0,0,0,0,0,0,0,0,0,0,0
/home/s1736883/Work/PParMetrics/benchmarks/snu-npb/nauseous-omp/LU/src/setbv.c(71),1,62,0.3065,1,0.4211,0.2,0.02857,0,0,30,18,12,24,12,12
/home/s1736883/Work/PParMetrics/benchmarks/snu-npb/nauseous-omp/LU/src/setbv.c(74),0,41,0.7561,0,0,0.3977,0.04545,0,0,27,27,0,0,0,0
/home/s1736883/Work/PParMetrics/benchmarks/snu-npb/nauseous-omp/LU/src/setbv.c(55),1,72,0.1528,1,0.7273,0.05263,0,0,0,24,12,12,24,12,12
/home/s1736883/Work/PParMetrics/benchmarks/snu-npb/nauseous-omp/LU/src/setbv.c(56),1,61,0.04918,0,0,0.1429,0.1,0,0,1,1,0,0,0,0
/home/s1736883/Work/PParMetrics/benchmarks/snu-npb/nauseous-omp/LU/src/setbv.c(59),0,40,0.75,0,0,0.3953,0.04651,0,0,26,26,0,0,0,0
/home/s1736883/Work/PParMetrics/benchmarks/snu-npb/nauseous-omp/LU/src/setiv.c(57),1,176,0.03409,1,0.5,0.03279,0.01093,0.1429,0.1429,7,5,2,4,2,2
/home/s1736883/Work/PParMetrics/benchmarks/snu-npb/nauseous-omp/LU/src/setiv.c(59),1,157,0.03822,1,0.5,0.04082,0.01361,0.1429,0.1429,7,5,2,4,2,2
/home/s1736883/Work/PParMetrics/benchmarks/snu-npb/nauseous-omp/LU/src/setiv.c(61),1,138,0.3478,2,0.2917,0.2485,0.0303,0.01538,0.01538,65,45,20,40,20,20
/home/s1736883/Work/PParMetrics/benchmarks/snu-npb/nauseous-omp/LU/src/setiv.c(70),0,89,0.8539,3,0.1974,0.3915,0.03302,0.1596,0.1596,94,82,12,24,12,12
/home/s1736883/Work/PParMetrics/benchmarks/snu-npb/nauseous-omp/LU/src/ssor.c(127),0,408,0.3333,4,0.3309,0.09825,0.003509,0.02899,0.01691,414,207,150,312,157,150
/home/s1736883/Work/PParMetrics/benchmarks/snu-npb/nauseous-omp/LU/src/ssor.c(142),1,72,0.1389,1,0.6,0.0641,0,0.05882,0.05882,17,9,8,16,8,8
/home/s1736883/Work/PParMetrics/benchmarks/snu-npb/nauseous-omp/LU/src/ssor.c(162),0,44,0.7727,0,0,0.359,0.02564,0,0,26,18,0,0,0,0
/home/s1736883/Work/PParMetrics/benchmarks/snu-npb/nauseous-omp/LU/src/ssor.c(190),0,44,0.8182,0,0,0.3846,0.02564,0,0,28,20,0,0,0,0
/home/s1736883/Work/PParMetrics/benchmarks/snu-npb/nauseous-omp/LU/src/ssor.c(225),1,86,0.1279,1,0.6364,0.05435,0,0.04762,0.04762,21,11,10,20,10,10
/home/s1736883/Work/PParMetrics/benchmarks/snu-npb/nauseous-omp/LU/src/ssor.c(143),1,59,0.1017,1,1,0.03333,0.01667,0,0,16,8,8,16,8,8
/home/s1736883/Work/PParMetrics/benchmarks/snu-npb/nauseous-omp/LU/src/ssor.c(226),1,73,0.09589,1,1,0.02857,0.01429,0,0,20,10,10,20,10,10
/home/s1736883/Work/PParMetrics/benchmarks/snu-npb/nauseous-omp/LU/src/ssor.c(144),1,47,0,0,0,0,0,0,0,0,0,0,0,0,0
/home/s1736883/Work/PParMetrics/benchmarks/snu-npb/nauseous-omp/LU/src/ssor.c(227),1,61,0,0,0,0,0,0,0,0,0,0,0,0,0
/home/s1736883/Work/PParMetrics/benchmarks/snu-npb/nauseous-omp/LU/src/ssor.c(145),1,36,0.7778,1,0.1071,0.3896,0.02597,0.1111,0.1111,27,26,1,4,3,1
/home/s1736883/Work/PParMetrics/benchmarks/snu-npb/nauseous-omp/LU/src/ssor.c(228),1,50,0.82,1,0.07317,0.4112,0.02804,0.075,0.075,40,39,1,4,3,1
/home/s1736883/Work/PParMetrics/benchmarks/snu-npb/nauseous-omp/LU/src/ssor.c(119),1,10,0.3,0,0,0.1905,0.04762,0,0,0,0,0,0,0,0
/home/s1736883/Work/PParMetrics/benchmarks/snu-npb/nauseous-omp/LU/src/ssor.c(104),1,10,0.3,0,0,0.1905,0.04762,0,0,0,0,0,0,0,0
/home/s1736883/Work/PParMetrics/benchmarks/snu-npb/nauseous-omp/LU/src/ssor.c(91),1,94,0.09574,1,0.8889,0.02885,0.009615,0.04,0.04,25,13,12,24,12,12
/home/s1736883/Work/PParMetrics/benchmarks/snu-npb/nauseous-omp/LU/src/ssor.c(92),1,81,0,0,0,0,0,0,0,0,0,0,0,0,0
/home/s1736883/Work/PParMetrics/benchmarks/snu-npb/nauseous-omp/LU/src/ssor.c(93),1,70,0,0,0,0,0,0,0,0,0,0,0,0,0
/home/s1736883/Work/PParMetrics/benchmarks/snu-npb/nauseous-omp/LU/src/ssor.c(94),1,60,0.8333,0,0,0.4355,0.03226,0,0,44,44,0,0,0,0
/home/s1736883/Work/PParMetrics/benchmarks/snu-npb/nauseous-omp/LU/src/ssor.c(78),1,93,0.08602,1,1,0.01961,0.009804,0,0,24,12,12,24,12,12
/home/s1736883/Work/PParMetrics/benchmarks/snu-npb/nauseous-omp/LU/src/ssor.c(79),1,81,0.1358,1,0.7273,0.05263,0,0,0,24,12,12,24,12,12
/home/s1736883/Work/PParMetrics/benchmarks/snu-npb/nauseous-omp/LU/src/ssor.c(80),1,70,0,0,0,0,0,0,0,0,0,0,0,0,0
/home/s1736883/Work/PParMetrics/benchmarks/snu-npb/nauseous-omp/LU/src/ssor.c(81),1,60,0.8333,0,0,0.4355,0.03226,0,0,44,44,0,0,0,0
/home/s1736883/Work/PParMetrics/benchmarks/snu-npb/nauseous-omp/LU/src/verify.c(348),0,66,0.2727,0,0,0.1795,0.0641,0,0,9,9,0,0,0,0
/home/s1736883/Work/PParMetrics/benchmarks/snu-npb/nauseous-omp/LU/src/verify.c(329),0,66,0.2727,0,0,0.1795,0.0641,0,0,9,9,0,0,0,0
/home/s1736883/Work/PParMetrics/benchmarks/snu-npb/nauseous-omp/LU/src/verify.c(301),1,48,0.7083,0,0,0.3818,0.07273,0,0,30,30,0,0,0,0
/home/s1736883/Work/PParMetrics/benchmarks/snu-npb/nauseous-omp/LU/src/verify.c(58),1,16,0.5,0,0,0.2941,0.05882,0,0,4,4,0,0,0,0
/home/s1736883/Work/PParMetrics/benchmarks/snu-npb/nauseous-omp/LU/src/syncs.c(47),0,7,0.1429,0,0,0.08333,0,0,0,0,0,0,0,0,0
/home/s1736883/Work/PParMetrics/benchmarks/snu-npb/nauseous-omp/LU/src/syncs.c(64),0,7,0.1429,0,0,0.08333,0,0,0,0,0,0,0,0,0
/home/s1736883/Work/PParMetrics/benchmarks/snu-npb/nauseous-omp/MG/src/mg.c(353),0,36,0.6944,1,0.32,0.2967,0.02198,0.1622,0.1622,37,27,10,22,12,10
/home/s1736883/Work/PParMetrics/benchmarks/snu-npb/nauseous-omp/MG/src/mg.c(271),0,55,0.6545,0,0,0.3143,0.009524,0,0,26,18,0,0,0,0
/home/s1736883/Work/PParMetrics/benchmarks/snu-npb/nauseous-omp/MG/src/mg.c(258),1,10,0.3,0,0,0.1905,0.04762,0,0,0,0,0,0,0,0
/home/s1736883/Work/PParMetrics/benchmarks/snu-npb/nauseous-omp/MG/src/mg.c(150),0,14,0.5,0,0,0.2759,0.03448,0,0,4,4,0,0,0,0
/home/s1736883/Work/PParMetrics/benchmarks/snu-npb/nauseous-omp/MG/src/mg.c(149),0,5,0.2,0,0,0.125,0,0,0,0,0,0,0,0,0
/home/s1736883/Work/PParMetrics/benchmarks/snu-npb/nauseous-omp/MG/src/mg.c(147),0,5,0.2,0,0,0.125,0,0,0,0,0,0,0,0,0
/home/s1736883/Work/PParMetrics/benchmarks/snu-npb/nauseous-omp/MG/src/mg.c(145),0,5,0.2,0,0,0.125,0,0,0,0,0,0,0,0,0
/home/s1736883/Work/PParMetrics/benchmarks/snu-npb/nauseous-omp/MG/src/mg.c(161),1,12,0.4167,0,0,0.24,0.04,0,0,2,2,0,0,0,0
/home/s1736883/Work/PParMetrics/benchmarks/snu-npb/nauseous-omp/MG/src/mg.c(113),1,10,0.3,0,0,0.1905,0.04762,0,0,0,0,0,0,0,0
/home/s1736883/Work/PParMetrics/benchmarks/snu-npb/nauseous-omp/MG/src/mg.c(1167),0,38,0.7368,0,0,0.3827,0.03704,0,0,25,25,0,0,0,0
/home/s1736883/Work/PParMetrics/benchmarks/snu-npb/nauseous-omp/MG/src/mg.c(1164),0,38,0.7368,0,0,0.3827,0.03704,0,0,25,25,0,0,0,0
/home/s1736883/Work/PParMetrics/benchmarks/snu-npb/nauseous-omp/MG/src/mg.c(1157),1,45,0.1778,1,0.625,0.08696,0,0,0,12,6,6,12,6,6
/home/s1736883/Work/PParMetrics/benchmarks/snu-npb/nauseous-omp/MG/src/mg.c(1158),1,34,0.2353,1,0.625,0.1176,0,0,0,12,6,6,12,6,6
/home/s1736883/Work/PParMetrics/benchmarks/snu-npb/nauseous-omp/MG/src/mg.c(1159),1,23,0.6522,0,0,0.3404,0.02128,0,0,12,12,0,0,0,0
/home/s1736883/Work/PParMetrics/benchmarks/snu-npb/nauseous-omp/MG/src/mg.c(1064),0,157,0.09554,3,0.6667,0.02817,0,0,0,16,8,8,16,8,8
/home/s1736883/Work/PParMetrics/benchmarks/snu-npb/nauseous-omp/MG/src/mg.c(1076),1,53,0.8679,2,0.3913,0.1765,0,0.2647,0.02941,68,38,2,30,16,2
/home/s1736883/Work/PParMetrics/benchmarks/snu-npb/nauseous-omp/MG/src/mg.c(1034),1,132,0.06061,1,0.625,0.04324,0.02162,0.1,0.1,10,6,4,8,4,4
/home/s1736883/Work/PParMetrics/benchmarks/snu-npb/nauseous-omp/MG/src/mg.c(1036),0,110,0,0,0,0,0,0,0,0,0,0,0,0,0
/home/s1736883/Work/PParMetrics/benchmarks/snu-npb/nauseous-omp/MG/src/mg.c(1037),0,98,0.1429,0,0,0.05344,0,0,0,8,8,0,0,0,0
/home/s1736883/Work/PParMetrics/benchmarks/snu-npb/nauseous-omp/MG/src/mg.c(1022),1,48,0.7083,0,0,0.4038,0.07692,0,0,24,24,0,0,0,0
/home/s1736883/Work/PParMetrics/benchmarks/snu-npb/nauseous-omp/MG/src/mg.c(1002),1,44,0.2955,2,0.5385,0.1915,0.02128,0.05882,0.05882,17,10,7,14,7,7
/home/s1736883/Work/PParMetrics/benchmarks/snu-npb/nauseous-omp/MG/src/mg.c(1004),0,28,0.7143,0,0,0.3818,0.01818,0,0,15,15,0,0,0,0
/home/s1736883/Work/PParMetrics/benchmarks/snu-npb/nauseous-omp/MG/src/mg.c(992),0,17,0.5294,0,0,0.2941,0.02941,0,0,5,5,0,0,0,0
/home/s1736883/Work/PParMetrics/benchmarks/snu-npb/nauseous-omp/MG/src/mg.c(563),1,267,0,0,0,0,0,0,0,0,0,0,0,0,0
/home/s1736883/Work/PParMetrics/benchmarks/snu-npb/nauseous-omp/MG/src/mg.c(564),0,255,0.1176,1,0.8667,0.02326,0,0,0,176,88,88,176,88,88
/home/s1736883/Work/PParMetrics/benchmarks/snu-npb/nauseous-omp/MG/src/mg.c(565),1,147,0.8844,0,0,0.4487,0.03205,0,0,126,126,0,0,0,0
/home/s1736883/Work/PParMetrics/benchmarks/snu-npb/nauseous-omp/MG/src/mg.c(571),0,94,0.8298,1,0.1538,0.4038,0.03756,0.09412,0.09412,85,80,5,21,16,5
/home/s1736883/Work/PParMetrics/benchmarks/snu-npb/nauseous-omp/MG/src/mg.c(449),0,146,0.7877,1,0.04348,0.4047,0.06745,0.0431,0.0431,116,112,4,8,4,4
/home/s1736883/Work/PParMetrics/benchmarks/snu-npb/nauseous-omp/MG/src/mg.c(436),0,55,0.7455,1,0.122,0.3672,0.04688,0.1111,0.1111,45,41,4,8,4,4
/home/s1736883/Work/PParMetrics/benchmarks/snu-npb/nauseous-omp/MG/src/mg.c(642),1,435,0.07356,2,0.8125,0.02703,0.003003,0.01754,0.01754,57,30,27,54,27,27
/home/s1736883/Work/PParMetrics/benchmarks/snu-npb/nauseous-omp/MG/src/mg.c(644),0,418,0.09091,2,0.8158,0.03915,0.003559,0.01031,0.01031,97,50,47,94,47,47
/home/s1736883/Work/PParMetrics/benchmarks/snu-npb/nauseous-omp/MG/src/mg.c(647),1,150,0.9467,1,0.07746,0.4483,0.003135,0.07006,0.07006,157,147,10,20,10,10
/home/s1736883/Work/PParMetrics/benchmarks/snu-npb/nauseous-omp/MG/src/mg.c(655),0,249,0.9598,2,0.1967,0.435,0.00361,0.1038,0.1038,289,261,28,84,56,28
/home/s1736883/Work/PParMetrics/benchmarks/snu-npb/nauseous-omp/MG/src/mg.c(500),1,292,0,0,0,0,0,0,0,0,0,0,0,0,0
/home/s1736883/Work/PParMetrics/benchmarks/snu-npb/nauseous-omp/MG/src/mg.c(501),0,280,0,0,0,0,0,0,0,0,0,0,0,0,0
/home/s1736883/Work/PParMetrics/benchmarks/snu-npb/nauseous-omp/MG/src/mg.c(502),1,147,0.8844,0,0,0.4487,0.03205,0,0,126,126,0,0,0,0
/home/s1736883/Work/PParMetrics/benchmarks/snu-npb/nauseous-omp/MG/src/mg.c(508),1,119,0.8571,1,0.1569,0.4126,0.03346,0.0885,0.0885,113,106,7,29,22,7
/home/s1736883/Work/PParMetrics/benchmarks/snu-npb/nauseous-omp/MG/src/mg.c(711),1,587,0,0,0,0,0,0,0,0,0,0,0,0,0
/home/s1736883/Work/PParMetrics/benchmarks/snu-npb/nauseous-omp/MG/src/mg.c(712),0,575,0,0,0,0,0,0,0,0,0,0,0,0,0
/home/s1736883/Work/PParMetrics/benchmarks/snu-npb/nauseous-omp/MG/src/mg.c(713),1,118,0.8559,1,0.0198,0.4353,0.03922,0.04082,0.04082,98,97,1,2,1,1
/home/s1736883/Work/PParMetrics/benchmarks/snu-npb/nauseous-omp/MG/src/mg.c(719),0,127,0.8819,1,0.3482,0.379,0.02229,0.1346,0.1346,156,132,24,85,61,24
/home/s1736883/Work/PParMetrics/benchmarks/snu-npb/nauseous-omp/MG/src/mg.c(725),1,102,0.8529,1,0.2529,0.3917,0.02917,0.1308,0.1308,107,95,12,44,32,12
/home/s1736883/Work/PParMetrics/benchmarks/snu-npb/nauseous-omp/MG/src/mg.c(731),1,102,0.8529,1,0.2529,0.3917,0.02917,0.1308,0.1308,107,95,12,44,32,12
/home/s1736883/Work/PParMetrics/benchmarks/snu-npb/nauseous-omp/MG/src/mg.c(737),1,106,0.8585,1,0.2418,0.3952,0.02823,0.1261,0.1261,111,99,12,44,32,12
/home/s1736883/Work/PParMetrics/benchmarks/snu-npb/nauseous-omp/MG/src/mg.c(802),1,600,0.05667,1,1,0.002408,0.0008026,0,0,240,120,120,240,120,120
/home/s1736883/Work/PParMetrics/benchmarks/snu-npb/nauseous-omp/MG/src/mg.c(803),0,244,0.07377,1,1,0.01304,0.004348,0,0,112,56,56,112,56,56
/home/s1736883/Work/PParMetrics/benchmarks/snu-npb/nauseous-omp/MG/src/mg.c(816),0,341,0.08504,1,0.8276,0.02071,0,0.006211,0.006211,161,81,80,160,80,80
/home/s1736883/Work/PParMetrics/benchmarks/snu-npb/nauseous-omp/MG/src/mg.c(804),0,98,0.8776,1,0.2674,0.4147,0.01843,0.1237,0.1237,97,90,7,36,29,7
/home/s1736883/Work/PParMetrics/benchmarks/snu-npb/nauseous-omp/MG/src/mg.c(809),0,131,0.8931,1,0.2991,0.4169,0.02034,0.1324,0.1324,136,125,11,56,45,11
/home/s1736883/Work/PParMetrics/benchmarks/snu-npb/nauseous-omp/MG/src/mg.c(817),0,131,0.8931,1,0.2991,0.4169,0.02034,0.1324,0.1324,136,125,11,56,45,11
/home/s1736883/Work/PParMetrics/benchmarks/snu-npb/nauseous-omp/MG/src/mg.c(823),0,195,0.9077,1,0.3333,0.4183,0.02237,0.1415,0.1415,212,193,19,96,77,19
/home/s1736883/Work/PParMetrics/benchmarks/snu-npb/nauseous-omp/MG/src/mg.c(773),1,452,0.05531,1,1,0.003456,0.001152,0,0,168,84,84,168,84,84
/home/s1736883/Work/PParMetrics/benchmarks/snu-npb/nauseous-omp/MG/src/mg.c(774),0,193,0.07772,1,1,0.01705,0.005682,0,0,88,44,44,88,44,44
/home/s1736883/Work/PParMetrics/benchmarks/snu-npb/nauseous-omp/MG/src/mg.c(786),0,244,0.07377,1,1,0.01304,0.004348,0,0,112,56,56,112,56,56
/home/s1736883/Work/PParMetrics/benchmarks/snu-npb/nauseous-omp/MG/src/mg.c(775),0,80,0.8625,1,0.2319,0.4114,0.01714,0.1184,0.1184,76,71,5,25,20,5
/home/s1736883/Work/PParMetrics/benchmarks/snu-npb/nauseous-omp/MG/src/mg.c(780),0,98,0.8776,1,0.2674,0.4147,0.01843,0.1237,0.1237,97,90,7,36,29,7
/home/s1736883/Work/PParMetrics/benchmarks/snu-npb/nauseous-omp/MG/src/mg.c(787),0,98,0.8776,1,0.2674,0.4147,0.01843,0.1237,0.1237,97,90,7,36,29,7
/home/s1736883/Work/PParMetrics/benchmarks/snu-npb/nauseous-omp/MG/src/mg.c(792),0,131,0.8931,1,0.2991,0.4169,0.02034,0.1324,0.1324,136,125,11,56,45,11
/home/s1736883/Work/PParMetrics/benchmarks/snu-npb/nauseous-omp/common/randdp.c(122),0,67,0.8806,1,0.7966,0.3571,0.005952,0.08989,0.08989,89,68,21,79,58,21
/home/s1736883/Work/PParMetrics/benchmarks/snu-npb/nauseous-omp/SP/src/add.c(46),1,81,0,0,0,0,0,0,0,0,0,0,0,0,0
/home/s1736883/Work/PParMetrics/benchmarks/snu-npb/nauseous-omp/SP/src/add.c(47),1,70,0.1429,1,0.7,0.05882,0,0,0,20,10,10,20,10,10
/home/s1736883/Work/PParMetrics/benchmarks/snu-npb/nauseous-omp/SP/src/add.c(48),1,59,0,0,0,0,0,0,0,0,0,0,0,0,0
/home/s1736883/Work/PParMetrics/benchmarks/snu-npb/nauseous-omp/SP/src/add.c(49),1,48,0.8125,1,0.07692,0.4078,0.02913,0.07895,0.07895,38,37,1,4,3,1
/home/s1736883/Work/PParMetrics/benchmarks/snu-npb/nauseous-omp/SP/src/error.c(80),1,46,0.1739,1,0.75,0.1268,0.05634,0.125,0.125,16,10,6,14,8,6
/home/s1736883/Work/PParMetrics/benchmarks/snu-npb/nauseous-omp/SP/src/error.c(81),1,25,0.72,1,0.3333,0.3455,0.01818,0.1579,0.1579,19,17,2,9,7,2
/home/s1736883/Work/PParMetrics/benchmarks/snu-npb/nauseous-omp/SP/src/error.c(74),1,19,0.5789,1,0.2727,0.2955,0.04545,0.2727,0.2727,11,10,1,4,3,1
/home/s1736883/Work/PParMetrics/benchmarks/snu-npb/nauseous-omp/SP/src/error.c(59),1,95,0.1474,2,0.5714,0.08738,0.009709,0.04762,0.04762,21,12,9,18,9,9
/home/s1736883/Work/PParMetrics/benchmarks/snu-npb/nauseous-omp/SP/src/error.c(61),0,78,0.1795,2,0.5714,0.1059,0.01176,0.04762,0.04762,21,12,9,18,9,9
/home/s1736883/Work/PParMetrics/benchmarks/snu-npb/nauseous-omp/SP/src/error.c(63),0,61,0.3279,2,0.5,0.1842,0.01316,0.06061,0.06061,33,20,13,26,13,13
/home/s1736883/Work/PParMetrics/benchmarks/snu-npb/nauseous-omp/SP/src/error.c(67),0,39,0.7436,2,0.2069,0.3667,0.04444,0.1935,0.1935,31,28,3,8,5,3
/home/s1736883/Work/PParMetrics/benchmarks/snu-npb/nauseous-omp/SP/src/error.c(55),1,12,0.4167,0,0,0.24,0.04,0,0,2,2,0,0,0,0
/home/s1736883/Work/PParMetrics/benchmarks/snu-npb/nauseous-omp/SP/src/error.c(48),1,13,0.4615,0,0,0.2593,0.03704,0,0,3,3,0,0,0,0
/home/s1736883/Work/PParMetrics/benchmarks/snu-npb/nauseous-omp/SP/src/error.c(122),1,46,0.4348,2,0.55,0.2113,0.02817,0.0625,0.0625,32,20,12,26,14,12
/home/s1736883/Work/PParMetrics/benchmarks/snu-npb/nauseous-omp/SP/src/error.c(123),1,25,0.72,1,0.3333,0.3455,0.01818,0.1579,0.1579,19,17,2,9,7,2
/home/s1736883/Work/PParMetrics/benchmarks/snu-npb/nauseous-omp/SP/src/error.c(116),1,19,0.5789,1,0.2727,0.2955,0.04545,0.2727,0.2727,11,10,1,4,3,1
/home/s1736883/Work/PParMetrics/benchmarks/snu-npb/nauseous-omp/SP/src/error.c(106),1,67,0.1194,1,0.625,0.05556,0,0,0,12,6,6,12,6,6
/home/s1736883/Work/PParMetrics/benchmarks/snu-npb/nauseous-omp/SP/src/error.c(107),0,56,0.1429,1,0.625,0.06667,0,0,0,12,6,6,12,6,6
/home/s1736883/Work/PParMetrics/benchmarks/snu-npb/nauseous-omp/SP/src/error.c(108),0,45,0.2222,1,0.7,0.08333,0,0,0,20,10,10,20,10,10
/home/s1736883/Work/PParMetrics/benchmarks/snu-npb/nauseous-omp/SP/src/error.c(109),1,34,0.7353,2,0.24,0.359,0.03846,0.2222,0.2222,27,24,3,8,5,3
/home/s1736883/Work/PParMetrics/benchmarks/snu-npb/nauseous-omp/SP/src/error.c(102),1,12,0.4167,0,0,0.24,0.04,0,0,2,2,0,0,0,0
/home/s1736883/Work/PParMetrics/benchmarks/snu-npb/nauseous-omp/SP/src/error.c(95),1,13,0.4615,0,0,0.2593,0.03704,0,0,3,3,0,0,0,0
/home/s1736883/Work/PParMetrics/benchmarks/snu-npb/nauseous-omp/SP/src/exact_rhs.c(352),1,71,0.1268,1,0.6667,0.05263,0,0,0,16,8,8,16,8,8
/home/s1736883/Work/PParMetrics/benchmarks/snu-npb/nauseous-omp/SP/src/exact_rhs.c(353),1,59,0,0,0,0,0,0,0,0,0,0,0,0,0
/home/s1736883/Work/PParMetrics/benchmarks/snu-npb/nauseous-omp/SP/src/exact_rhs.c(354),1,47,0,0,0,0,0,0,0,0,0,0,0,0,0
/home/s1736883/Work/PParMetrics/benchmarks/snu-npb/nauseous-omp/SP/src/exact_rhs.c(355),1,35,0.7714,1,0.1111,0.3867,0.02667,0.07692,0.07692,26,25,1,4,3,1
/home/s1736883/Work/PParMetrics/benchmarks/snu-npb/nauseous-omp/SP/src/exact_rhs.c(256),1,1078,0.002783,1,0.6667,0.001287,0.0006437,0.3333,0.3333,3,2,1,2,1,1
/home/s1736883/Work/PParMetrics/benchmarks/snu-npb/nauseous-omp/SP/src/exact_rhs.c(258),0,1061,0.002828,1,0.6667,0.001324,0.000662,0.3333,0.3333,3,2,1,2,1,1
/home/s1736883/Work/PParMetrics/benchmarks/snu-npb/nauseous-omp/SP/src/exact_rhs.c(261),1,156,0.6667,5,0.3654,0.2903,0.0457,0.1257,0.1257,191,135,56,124,68,56
/home/s1736883/Work/PParMetrics/benchmarks/snu-npb/nauseous-omp/SP/src/exact_rhs.c(281),1,517,0.94,3,0.1523,0.4189,0.01893,0.1195,0.1195,619,548,71,163,92,71
/home/s1736883/Work/PParMetrics/benchmarks/snu-npb/nauseous-omp/SP/src/exact_rhs.c(317),1,132,0.8712,2,0.1652,0.3772,0.03293,0.1056,0.1056,161,135,26,56,30,26
/home/s1736883/Work/PParMetrics/benchmarks/snu-npb/nauseous-omp/SP/src/exact_rhs.c(327),1,95,0,0,0,0,0,0,0,0,0,0,0,0,0
/home/s1736883/Work/PParMetrics/benchmarks/snu-npb/nauseous-omp/SP/src/exact_rhs.c(335),1,136,0.875,2,0.1597,0.3801,0.03216,0.1152,0.1152,165,139,26,56,30,26
/home/s1736883/Work/PParMetrics/benchmarks/snu-npb/nauseous-omp/SP/src/exact_rhs.c(265),0,19,0.5789,0,0,0.3171,0.04878,0,0,8,8,0,0,0,0
/home/s1736883/Work/PParMetrics/benchmarks/snu-npb/nauseous-omp/SP/src/exact_rhs.c(271),1,21,0.619,0,0,0.3333,0.04444,0,0,10,10,0,0,0,0
/home/s1736883/Work/PParMetrics/benchmarks/snu-npb/nauseous-omp/SP/src/exact_rhs.c(328),1,83,0.8434,1,0.04286,0.4254,0.03867,0.04348,0.04348,69,68,1,4,3,1
/home/s1736883/Work/PParMetrics/benchmarks/snu-npb/nauseous-omp/SP/src/exact_rhs.c(161),1,1078,0.002783,1,0.6667,0.001287,0.0006437,0.3333,0.3333,3,2,1,2,1,1
/home/s1736883/Work/PParMetrics/benchmarks/snu-npb/nauseous-omp/SP/src/exact_rhs.c(163),0,1061,0.002828,1,0.6667,0.001324,0.000662,0.3333,0.3333,3,2,1,2,1,1
/home/s1736883/Work/PParMetrics/benchmarks/snu-npb/nauseous-omp/SP/src/exact_rhs.c(166),1,156,0.6667,5,0.3654,0.2903,0.0457,0.1257,0.1257,191,135,56,124,68,56
/home/s1736883/Work/PParMetrics/benchmarks/snu-npb/nauseous-omp/SP/src/exact_rhs.c(185),1,517,0.94,3,0.1523,0.4189,0.01893,0.1195,0.1195,619,548,71,163,92,71
/home/s1736883/Work/PParMetrics/benchmarks/snu-npb/nauseous-omp/SP/src/exact_rhs.c(222),1,132,0.8712,2,0.1652,0.3772,0.03293,0.1056,0.1056,161,135,26,56,30,26
/home/s1736883/Work/PParMetrics/benchmarks/snu-npb/nauseous-omp/SP/src/exact_rhs.c(232),1,95,0,0,0,0,0,0,0,0,0,0,0,0,0
/home/s1736883/Work/PParMetrics/benchmarks/snu-npb/nauseous-omp/SP/src/exact_rhs.c(240),1,136,0.875,2,0.1597,0.3801,0.03216,0.1152,0.1152,165,139,26,56,30,26
/home/s1736883/Work/PParMetrics/benchmarks/snu-npb/nauseous-omp/SP/src/exact_rhs.c(170),0,19,0.5789,0,0,0.3171,0.04878,0,0,8,8,0,0,0,0
/home/s1736883/Work/PParMetrics/benchmarks/snu-npb/nauseous-omp/SP/src/exact_rhs.c(175),1,21,0.619,0,0,0.3333,0.04444,0,0,10,10,0,0,0,0
/home/s1736883/Work/PParMetrics/benchmarks/snu-npb/nauseous-omp/SP/src/exact_rhs.c(233),1,83,0.8434,1,0.04286,0.4254,0.03867,0.04348,0.04348,69,68,1,4,3,1
/home/s1736883/Work/PParMetrics/benchmarks/snu-npb/nauseous-omp/SP/src/exact_rhs.c(66),1,1078,0.002783,1,0.6667,0.001287,0.0006437,0.3333,0.3333,3,2,1,2,1,1
/home/s1736883/Work/PParMetrics/benchmarks/snu-npb/nauseous-omp/SP/src/exact_rhs.c(68),0,1061,0.002828,1,0.6667,0.001324,0.000662,0.3333,0.3333,3,2,1,2,1,1
/home/s1736883/Work/PParMetrics/benchmarks/snu-npb/nauseous-omp/SP/src/exact_rhs.c(71),1,156,0.6667,5,0.3654,0.2903,0.0457,0.1257,0.1257,191,135,56,124,68,56
/home/s1736883/Work/PParMetrics/benchmarks/snu-npb/nauseous-omp/SP/src/exact_rhs.c(91),1,517,0.94,3,0.1523,0.4189,0.01893,0.1195,0.1195,619,548,71,163,92,71
/home/s1736883/Work/PParMetrics/benchmarks/snu-npb/nauseous-omp/SP/src/exact_rhs.c(127),1,132,0.8712,2,0.1652,0.3772,0.03293,0.1056,0.1056,161,135,26,56,30,26
/home/s1736883/Work/PParMetrics/benchmarks/snu-npb/nauseous-omp/SP/src/exact_rhs.c(137),1,95,0,0,0,0,0,0,0,0,0,0,0,0,0
/home/s1736883/Work/PParMetrics/benchmarks/snu-npb/nauseous-omp/SP/src/exact_rhs.c(145),1,136,0.875,2,0.1597,0.3801,0.03216,0.1152,0.1152,165,139,26,56,30,26
/home/s1736883/Work/PParMetrics/benchmarks/snu-npb/nauseous-omp/SP/src/exact_rhs.c(75),0,19,0.5789,0,0,0.3171,0.04878,0,0,8,8,0,0,0,0
/home/s1736883/Work/PParMetrics/benchmarks/snu-npb/nauseous-omp/SP/src/exact_rhs.c(81),1,21,0.619,0,0,0.3333,0.04444,0,0,10,10,0,0,0,0
/home/s1736883/Work/PParMetrics/benchmarks/snu-npb/nauseous-omp/SP/src/exact_rhs.c(138),1,83,0.8434,1,0.04286,0.4254,0.03867,0.04348,0.04348,69,68,1,4,3,1
/home/s1736883/Work/PParMetrics/benchmarks/snu-npb/nauseous-omp/SP/src/exact_rhs.c(52),1,57,0.1404,1,0.625,0.06667,0,0,0,12,6,6,12,6,6
/home/s1736883/Work/PParMetrics/benchmarks/snu-npb/nauseous-omp/SP/src/exact_rhs.c(53),1,45,0,0,0,0,0,0,0,0,0,0,0,0,0
/home/s1736883/Work/PParMetrics/benchmarks/snu-npb/nauseous-omp/SP/src/exact_rhs.c(54),1,33,0.2424,1,0.625,0.1111,0,0,0,12,6,6,12,6,6
/home/s1736883/Work/PParMetrics/benchmarks/snu-npb/nauseous-omp/SP/src/exact_solution.c(44),0,114,0.8246,1,0.4043,0.3843,0.04982,0.2222,0.2222,117,104,13,63,50,13
/home/s1736883/Work/PParMetrics/benchmarks/snu-npb/nauseous-omp/SP/src/initialize.c(203),1,64,0.2188,2,0.5714,0.1268,0.01408,0.04762,0.04762,21,12,9,18,9,9
/home/s1736883/Work/PParMetrics/benchmarks/snu-npb/nauseous-omp/SP/src/initialize.c(205),1,47,0.383,2,0.4444,0.2258,0.01613,0.08,0.08,25,16,9,18,9,9
/home/s1736883/Work/PParMetrics/benchmarks/snu-npb/nauseous-omp/SP/src/initialize.c(208),0,25,0.68,0,0,0.3585,0.03774,0,0,14,14,0,0,0,0
/home/s1736883/Work/PParMetrics/benchmarks/snu-npb/nauseous-omp/SP/src/initialize.c(186),1,64,0.2188,2,0.5714,0.1268,0.01408,0.04762,0.04762,21,12,9,18,9,9
/home/s1736883/Work/PParMetrics/benchmarks/snu-npb/nauseous-omp/SP/src/initialize.c(188),1,47,0.383,2,0.4444,0.2258,0.01613,0.08,0.08,25,16,9,18,9,9
/home/s1736883/Work/PParMetrics/benchmarks/snu-npb/nauseous-omp/SP/src/initialize.c(191),0,25,0.68,0,0,0.3585,0.03774,0,0,14,14,0,0,0,0
/home/s1736883/Work/PParMetrics/benchmarks/snu-npb/nauseous-omp/SP/src/initialize.c(169),1,64,0.2188,2,0.5714,0.1268,0.01408,0.04762,0.04762,21,12,9,18,9,9
/home/s1736883/Work/PParMetrics/benchmarks/snu-npb/nauseous-omp/SP/src/initialize.c(171),1,47,0.08511,1,0.5,0.1452,0.08065,0.5,0.5,4,3,1,2,1,1
/home/s1736883/Work/PParMetrics/benchmarks/snu-npb/nauseous-omp/SP/src/initialize.c(174),0,25,0.68,0,0,0.3585,0.03774,0,0,14,14,0,0,0,0
/home/s1736883/Work/PParMetrics/benchmarks/snu-npb/nauseous-omp/SP/src/initialize.c(152),1,64,0.2188,2,0.5714,0.1268,0.01408,0.04762,0.04762,21,12,9,18,9,9
/home/s1736883/Work/PParMetrics/benchmarks/snu-npb/nauseous-omp/SP/src/initialize.c(154),1,47,0.08511,1,0.5,0.1452,0.08065,0.5,0.5,4,3,1,2,1,1
/home/s1736883/Work/PParMetrics/benchmarks/snu-npb/nauseous-omp/SP/src/initialize.c(157),0,25,0.68,0,0,0.3585,0.03774,0,0,14,14,0,0,0,0
/home/s1736883/Work/PParMetrics/benchmarks/snu-npb/nauseous-omp/SP/src/initialize.c(135),1,64,0.2188,2,0.5714,0.1268,0.01408,0.04762,0.04762,21,12,9,18,9,9
/home/s1736883/Work/PParMetrics/benchmarks/snu-npb/nauseous-omp/SP/src/initialize.c(137),1,47,0.383,2,0.4444,0.2258,0.01613,0.08,0.08,25,16,9,18,9,9
/home/s1736883/Work/PParMetrics/benchmarks/snu-npb/nauseous-omp/SP/src/initialize.c(140),0,25,0.68,0,0,0.3585,0.03774,0,0,14,14,0,0,0,0
/home/s1736883/Work/PParMetrics/benchmarks/snu-npb/nauseous-omp/SP/src/initialize.c(118),1,64,0.2188,2,0.5714,0.1268,0.01408,0.04762,0.04762,21,12,9,18,9,9
/home/s1736883/Work/PParMetrics/benchmarks/snu-npb/nauseous-omp/SP/src/initialize.c(120),1,47,0.383,2,0.4444,0.2258,0.01613,0.08,0.08,25,16,9,18,9,9
/home/s1736883/Work/PParMetrics/benchmarks/snu-npb/nauseous-omp/SP/src/initialize.c(123),0,25,0.68,0,0,0.3585,0.03774,0,0,14,14,0,0,0,0
/home/s1736883/Work/PParMetrics/benchmarks/snu-npb/nauseous-omp/SP/src/initialize.c(72),1,218,0.02752,1,0.8333,0.01702,0.008511,0.1111,0.1111,9,5,4,8,4,4
/home/s1736883/Work/PParMetrics/benchmarks/snu-npb/nauseous-omp/SP/src/initialize.c(74),0,201,0.02985,1,0.8333,0.01896,0.009479,0.1111,0.1111,9,5,4,8,4,4
/home/s1736883/Work/PParMetrics/benchmarks/snu-npb/nauseous-omp/SP/src/initialize.c(76),0,184,0.2337,5,0.7907,0.07772,0.005181,0.01053,0.01053,95,49,46,92,46,46
/home/s1736883/Work/PParMetrics/benchmarks/snu-npb/nauseous-omp/SP/src/initialize.c(79),0,20,0.6,1,0.1667,0.3182,0.04545,0.2,0.2,10,9,1,2,1,1
/home/s1736883/Work/PParMetrics/benchmarks/snu-npb/nauseous-omp/SP/src/initialize.c(84),0,20,0.6,1,0.1667,0.3182,0.04545,0.2,0.2,10,9,1,2,1,1
/home/s1736883/Work/PParMetrics/benchmarks/snu-npb/nauseous-omp/SP/src/initialize.c(89),0,20,0.6,1,0.1667,0.3182,0.04545,0.2,0.2,10,9,1,2,1,1
/home/s1736883/Work/PParMetrics/benchmarks/snu-npb/nauseous-omp/SP/src/initialize.c(94),1,101,0.8713,3,0.1705,0.4025,0.02966,0.1415,0.1415,106,94,12,24,12,12
/home/s1736883/Work/PParMetrics/benchmarks/snu-npb/nauseous-omp/SP/src/initialize.c(56),1,89,0,0,0,0,0,0,0,0,0,0,0,0,0
/home/s1736883/Work/PParMetrics/benchmarks/snu-npb/nauseous-omp/SP/src/initialize.c(57),1,77,0,0,0,0,0,0,0,0,0,0,0,0,0
/home/s1736883/Work/PParMetrics/benchmarks/snu-npb/nauseous-omp/SP/src/initialize.c(58),1,65,0.8,0,0,0.4222,0.03704,0,0,45,45,0,0,0,0
/home/s1736883/Work/PParMetrics/benchmarks/snu-npb/nauseous-omp/SP/src/initialize.c(225),1,115,0.2348,0,0,0.2338,0.05844,0,0,21,21,0,0,0,0
/home/s1736883/Work/PParMetrics/benchmarks/snu-npb/nauseous-omp/SP/src/initialize.c(226),1,62,0.8065,0,0,0.4308,0.04615,0,0,42,42,0,0,0,0
/home/s1736883/Work/PParMetrics/benchmarks/snu-npb/nauseous-omp/SP/src/initialize.c(252),1,109,0.2202,0,0,0.223,0.06081,0,0,18,18,0,0,0,0
/home/s1736883/Work/PParMetrics/benchmarks/snu-npb/nauseous-omp/SP/src/initialize.c(253),1,59,0.7966,0,0,0.4274,0.04839,0,0,39,39,0,0,0,0
/home/s1736883/Work/PParMetrics/benchmarks/snu-npb/nauseous-omp/SP/src/ninvr.c(47),1,170,0.1,1,0.8235,0.01923,0,0,0,48,24,24,48,24,24
/home/s1736883/Work/PParMetrics/benchmarks/snu-npb/nauseous-omp/SP/src/ninvr.c(48),1,159,0,0,0,0,0,0,0,0,0,0,0,0,0
/home/s1736883/Work/PParMetrics/benchmarks/snu-npb/nauseous-omp/SP/src/ninvr.c(49),1,148,0.8851,1,0.2824,0.375,0.0266,0.06349,0.06349,189,153,36,97,61,36
/home/s1736883/Work/PParMetrics/benchmarks/snu-npb/nauseous-omp/SP/src/pinvr.c(47),1,170,0,0,0,0,0,0,0,0,0,0,0,0,0
/home/s1736883/Work/PParMetrics/benchmarks/snu-npb/nauseous-omp/SP/src/pinvr.c(48),1,159,0,0,0,0,0,0,0,0,0,0,0,0,0
/home/s1736883/Work/PParMetrics/benchmarks/snu-npb/nauseous-omp/SP/src/pinvr.c(49),1,148,0.8851,1,0.2824,0.375,0.0266,0.06349,0.06349,189,153,36,97,61,36
/home/s1736883/Work/PParMetrics/benchmarks/snu-npb/nauseous-omp/SP/src/rhs.c(395),1,69,0.1304,1,0.6667,0.05405,0,0,0,16,8,8,16,8,8
/home/s1736883/Work/PParMetrics/benchmarks/snu-npb/nauseous-omp/SP/src/rhs.c(396),1,58,0,0,0,0,0,0,0,0,0,0,0,0,0
/home/s1736883/Work/PParMetrics/benchmarks/snu-npb/nauseous-omp/SP/src/rhs.c(397),1,47,0,0,0,0,0,0,0,0,0,0,0,0,0
/home/s1736883/Work/PParMetrics/benchmarks/snu-npb/nauseous-omp/SP/src/rhs.c(398),1,36,0.7778,1,0.1071,0.3896,0.02597,0.1111,0.1111,27,26,1,4,3,1
/home/s1736883/Work/PParMetrics/benchmarks/snu-npb/nauseous-omp/SP/src/rhs.c(383),1,106,0,0,0,0,0,0,0,0,0,0,0,0,0
/home/s1736883/Work/PParMetrics/benchmarks/snu-npb/nauseous-omp/SP/src/rhs.c(384),1,94,0.1277,1,0.75,0.06452,0,0,0,28,14,14,28,14,14
/home/s1736883/Work/PParMetrics/benchmarks/snu-npb/nauseous-omp/SP/src/rhs.c(385),1,82,0.8659,1,0.04225,0.4343,0.02857,0.04286,0.04286,70,69,1,4,3,1
/home/s1736883/Work/PParMetrics/benchmarks/snu-npb/nauseous-omp/SP/src/rhs.c(371),1,122,0,0,0,0,0,0,0,0,0,0,0,0,0
/home/s1736883/Work/PParMetrics/benchmarks/snu-npb/nauseous-omp/SP/src/rhs.c(372),1,110,0.1182,1,0.7692,0.05882,0,0,0,32,16,16,32,16,16
/home/s1736883/Work/PParMetrics/benchmarks/snu-npb/nauseous-omp/SP/src/rhs.c(373),1,98,0.8776,1,0.03488,0.4402,0.02871,0.03529,0.03529,85,84,1,4,3,1
/home/s1736883/Work/PParMetrics/benchmarks/snu-npb/nauseous-omp/SP/src/rhs.c(356),1,149,0,0,0,0,0,0,0,0,0,0,0,0,0
/home/s1736883/Work/PParMetrics/benchmarks/snu-npb/nauseous-omp/SP/src/rhs.c(357),1,137,0,0,0,0,0,0,0,0,0,0,0,0,0
/home/s1736883/Work/PParMetrics/benchmarks/snu-npb/nauseous-omp/SP/src/rhs.c(358),1,125,0.112,1,0.7857,0.05405,0,0,0,36,18,18,36,18,18
/home/s1736883/Work/PParMetrics/benchmarks/snu-npb/nauseous-omp/SP/src/rhs.c(359),1,113,0.885,1,0.03,0.444,0.02905,0.0303,0.0303,99,98,1,4,3,1
/home/s1736883/Work/PParMetrics/benchmarks/snu-npb/nauseous-omp/SP/src/rhs.c(345),1,122,0.1066,1,0.7692,0.04,0,0,0,32,16,16,32,16,16
/home/s1736883/Work/PParMetrics/benchmarks/snu-npb/nauseous-omp/SP/src/rhs.c(346),1,110,0,0,0,0,0,0,0,0,0,0,0,0,0
/home/s1736883/Work/PParMetrics/benchmarks/snu-npb/nauseous-omp/SP/src/rhs.c(347),1,98,0.8776,1,0.03488,0.4402,0.02871,0.03529,0.03529,85,84,1,4,3,1
/home/s1736883/Work/PParMetrics/benchmarks/snu-npb/nauseous-omp/SP/src/rhs.c(334),1,106,0,0,0,0,0,0,0,0,0,0,0,0,0
/home/s1736883/Work/PParMetrics/benchmarks/snu-npb/nauseous-omp/SP/src/rhs.c(335),1,94,0,0,0,0,0,0,0,0,0,0,0,0,0
/home/s1736883/Work/PParMetrics/benchmarks/snu-npb/nauseous-omp/SP/src/rhs.c(336),1,82,0.8659,1,0.04225,0.4343,0.02857,0.04286,0.04286,70,69,1,4,3,1
/home/s1736883/Work/PParMetrics/benchmarks/snu-npb/nauseous-omp/SP/src/rhs.c(288),1,840,0,0,0,0,0,0,0,0,0,0,0,0,0
/home/s1736883/Work/PParMetrics/benchmarks/snu-npb/nauseous-omp/SP/src/rhs.c(289),1,828,0,0,0,0,0,0,0,0,0,0,0,0,0
/home/s1736883/Work/PParMetrics/benchmarks/snu-npb/nauseous-omp/SP/src/rhs.c(290),1,816,0.9179,4,0.06142,0.4425,0.03231,0.05589,0.05589,823,781,42,105,63,42
/home/s1736883/Work/PParMetrics/benchmarks/snu-npb/nauseous-omp/SP/src/rhs.c(190),1,1394,0.07245,1,0.9901,0.001764,0.000392,0.0006789,0.0006789,1473,737,736,1472,736,736
/home/s1736883/Work/PParMetrics/benchmarks/snu-npb/nauseous-omp/SP/src/rhs.c(191),1,826,0,0,0,0,0,0,0,0,0,0,0,0,0
/home/s1736883/Work/PParMetrics/benchmarks/snu-npb/nauseous-omp/SP/src/rhs.c(234),1,93,0,0,0,0,0,0,0,0,0,0,0,0,0
/home/s1736883/Work/PParMetrics/benchmarks/snu-npb/nauseous-omp/SP/src/rhs.c(242),1,109,0,0,0,0,0,0,0,0,0,0,0,0,0
/home/s1736883/Work/PParMetrics/benchmarks/snu-npb/nauseous-omp/SP/src/rhs.c(250),1,136,0,0,0,0,0,0,0,0,0,0,0,0,0
/home/s1736883/Work/PParMetrics/benchmarks/snu-npb/nauseous-omp/SP/src/rhs.c(262),1,109,0.1193,1,0.7692,0.06061,0,0,0,32,16,16,32,16,16
/home/s1736883/Work/PParMetrics/benchmarks/snu-npb/nauseous-omp/SP/src/rhs.c(271),1,93,0.129,1,0.75,0.06667,0,0,0,28,14,14,28,14,14
/home/s1736883/Work/PParMetrics/benchmarks/snu-npb/nauseous-omp/SP/src/rhs.c(192),1,815,0.919,4,0.06142,0.443,0.03235,0.05589,0.05589,823,781,42,105,63,42
/home/s1736883/Work/PParMetrics/benchmarks/snu-npb/nauseous-omp/SP/src/rhs.c(235),1,82,0.8659,1,0.04225,0.4343,0.02857,0.04286,0.04286,70,69,1,4,3,1
/home/s1736883/Work/PParMetrics/benchmarks/snu-npb/nauseous-omp/SP/src/rhs.c(243),1,98,0.8776,1,0.03488,0.4402,0.02871,0.03529,0.03529,85,84,1,4,3,1
/home/s1736883/Work/PParMetrics/benchmarks/snu-npb/nauseous-omp/SP/src/rhs.c(251),1,124,0.1129,1,0.7857,0.05556,0,0,0,36,18,18,36,18,18
/home/s1736883/Work/PParMetrics/benchmarks/snu-npb/nauseous-omp/SP/src/rhs.c(263),1,98,0.8776,1,0.03488,0.4402,0.02871,0.03529,0.03529,85,84,1,4,3,1
/home/s1736883/Work/PParMetrics/benchmarks/snu-npb/nauseous-omp/SP/src/rhs.c(272),1,82,0.8659,1,0.04225,0.4343,0.02857,0.04286,0.04286,70,69,1,4,3,1
/home/s1736883/Work/PParMetrics/benchmarks/snu-npb/nauseous-omp/SP/src/rhs.c(252),1,113,0.885,1,0.03,0.444,0.02905,0.0303,0.0303,99,98,1,4,3,1
/home/s1736883/Work/PParMetrics/benchmarks/snu-npb/nauseous-omp/SP/src/rhs.c(96),1,1372,0,0,0,0,0,0,0,0,0,0,0,0,0
/home/s1736883/Work/PParMetrics/benchmarks/snu-npb/nauseous-omp/SP/src/rhs.c(97),1,826,0,0,0,0,0,0,0,0,0,0,0,0,0
/home/s1736883/Work/PParMetrics/benchmarks/snu-npb/nauseous-omp/SP/src/rhs.c(139),1,195,0,0,0,0,0,0,0,0,0,0,0,0,0
/home/s1736883/Work/PParMetrics/benchmarks/snu-npb/nauseous-omp/SP/src/rhs.c(154),1,136,0,0,0,0,0,0,0,0,0,0,0,0,0
/home/s1736883/Work/PParMetrics/benchmarks/snu-npb/nauseous-omp/SP/src/rhs.c(165),1,198,0.07071,1,0.9286,0.02232,0.008929,0.02222,0.02222,45,23,22,44,22,22
/home/s1736883/Work/PParMetrics/benchmarks/snu-npb/nauseous-omp/SP/src/rhs.c(98),1,815,0.919,4,0.06142,0.443,0.03235,0.05589,0.05589,823,781,42,105,63,42
/home/s1736883/Work/PParMetrics/benchmarks/snu-npb/nauseous-omp/SP/src/rhs.c(141),1,82,0.8659,1,0.04225,0.4343,0.02857,0.04286,0.04286,70,69,1,4,3,1
/home/s1736883/Work/PParMetrics/benchmarks/snu-npb/nauseous-omp/SP/src/rhs.c(147),1,98,0.8776,1,0.03488,0.4402,0.02871,0.03529,0.03529,85,84,1,4,3,1
/home/s1736883/Work/PParMetrics/benchmarks/snu-npb/nauseous-omp/SP/src/rhs.c(155),1,125,0,0,0,0,0,0,0,0,0,0,0,0,0
/home/s1736883/Work/PParMetrics/benchmarks/snu-npb/nauseous-omp/SP/src/rhs.c(167),1,98,0.8776,1,0.03488,0.4402,0.02871,0.03529,0.03529,85,84,1,4,3,1
/home/s1736883/Work/PParMetrics/benchmarks/snu-npb/nauseous-omp/SP/src/rhs.c(174),1,82,0.8659,1,0.04225,0.4343,0.02857,0.04286,0.04286,70,69,1,4,3,1
/home/s1736883/Work/PParMetrics/benchmarks/snu-npb/nauseous-omp/SP/src/rhs.c(156),1,113,0.885,1,0.03,0.444,0.02905,0.0303,0.0303,99,98,1,4,3,1
/home/s1736883/Work/PParMetrics/benchmarks/snu-npb/nauseous-omp/SP/src/rhs.c(80),1,70,0,0,0,0,0,0,0,0,0,0,0,0,0
/home/s1736883/Work/PParMetrics/benchmarks/snu-npb/nauseous-omp/SP/src/rhs.c(81),0,58,0,0,0,0,0,0,0,0,0,0,0,0,0
/home/s1736883/Work/PParMetrics/benchmarks/snu-npb/nauseous-omp/SP/src/rhs.c(82),0,46,0,0,0,0,0,0,0,0,0,0,0,0,0
/home/s1736883/Work/PParMetrics/benchmarks/snu-npb/nauseous-omp/SP/src/rhs.c(83),0,34,0.7647,0,0,0.3944,0.02817,0,0,23,23,0,0,0,0
/home/s1736883/Work/PParMetrics/benchmarks/snu-npb/nauseous-omp/SP/src/rhs.c(52),1,272,0,0,0,0,0,0,0,0,0,0,0,0,0
/home/s1736883/Work/PParMetrics/benchmarks/snu-npb/nauseous-omp/SP/src/rhs.c(53),1,260,0,0,0,0,0,0,0,0,0,0,0,0,0
/home/s1736883/Work/PParMetrics/benchmarks/snu-npb/nauseous-omp/SP/src/rhs.c(54),1,248,0.8871,3,0.05909,0.4388,0.03656,0.06987,0.06987,229,219,10,20,10,10
/home/s1736883/Work/PParMetrics/benchmarks/snu-npb/nauseous-omp/SP/src/sp.c(231),0,91,0.8242,1,0.1867,0.2651,0.01606,0.1049,0.08392,143,94,36,74,38,36
/home/s1736883/Work/PParMetrics/benchmarks/snu-npb/nauseous-omp/SP/src/sp.c(225),0,14,0.4286,0,0,0.2581,0.06452,0,0,3,3,0,0,0,0
/home/s1736883/Work/PParMetrics/benchmarks/snu-npb/nauseous-omp/SP/src/sp.c(191),0,20,0.25,0,0,0.1818,0.02273,0,0,0,0,0,0,0,0
/home/s1736883/Work/PParMetrics/benchmarks/snu-npb/nauseous-omp/SP/src/sp.c(186),1,10,0.3,0,0,0.1905,0.04762,0,0,0,0,0,0,0,0
/home/s1736883/Work/PParMetrics/benchmarks/snu-npb/nauseous-omp/SP/src/sp.c(172),1,10,0.3,0,0,0.1905,0.04762,0,0,0,0,0,0,0,0
/home/s1736883/Work/PParMetrics/benchmarks/snu-npb/nauseous-omp/SP/src/sp.c(141),0,5,0.2,0,0,0.125,0,0,0,0,0,0,0,0,0
/home/s1736883/Work/PParMetrics/benchmarks/snu-npb/nauseous-omp/SP/src/sp.c(139),0,5,0.2,0,0,0.125,0,0,0,0,0,0,0,0,0
/home/s1736883/Work/PParMetrics/benchmarks/snu-npb/nauseous-omp/SP/src/txinvr.c(48),1,279,0,0,0,0,0,0,0,0,0,0,0,0,0
/home/s1736883/Work/PParMetrics/benchmarks/snu-npb/nauseous-omp/SP/src/txinvr.c(49),1,268,0.08582,1,0.8696,0.01681,0,0,0,72,36,36,72,36,36
/home/s1736883/Work/PParMetrics/benchmarks/snu-npb/nauseous-omp/SP/src/txinvr.c(50),1,257,0.9105,7,0.3376,0.39,0.02496,0.08563,0.08563,327,270,57,160,103,57
/home/s1736883/Work/PParMetrics/benchmarks/snu-npb/nauseous-omp/SP/src/tzetar.c(49),1,282,0,0,0,0,0,0,0,0,0,0,0,0,0
/home/s1736883/Work/PParMetrics/benchmarks/snu-npb/nauseous-omp/SP/src/tzetar.c(50),1,271,0.08487,1,0.8696,0.01653,0,0,0,72,36,36,72,36,36
/home/s1736883/Work/PParMetrics/benchmarks/snu-npb/nauseous-omp/SP/src/tzetar.c(51),1,260,0.9115,8,0.346,0.3892,0.02462,0.09009,0.09009,333,274,59,164,105,59
/home/s1736883/Work/PParMetrics/benchmarks/snu-npb/nauseous-omp/SP/src/verify.c(320),0,63,0.2857,0,0,0.1867,0.06667,0,0,9,9,0,0,0,0
/home/s1736883/Work/PParMetrics/benchmarks/snu-npb/nauseous-omp/SP/src/verify.c(301),0,63,0.2857,0,0,0.1867,0.06667,0,0,9,9,0,0,0,0
/home/s1736883/Work/PParMetrics/benchmarks/snu-npb/nauseous-omp/SP/src/verify.c(275),1,46,0.6957,0,0,0.3774,0.07547,0,0,28,28,0,0,0,0
/home/s1736883/Work/PParMetrics/benchmarks/snu-npb/nauseous-omp/SP/src/verify.c(70),0,16,0.5,0,0,0.2941,0.05882,0,0,4,4,0,0,0,0
/home/s1736883/Work/PParMetrics/benchmarks/snu-npb/nauseous-omp/SP/src/verify.c(63),0,18,0.5556,1,0.3,0.2927,0.04878,0.3333,0.3333,9,8,1,4,3,1
/home/s1736883/Work/PParMetrics/benchmarks/snu-npb/nauseous-omp/SP/src/x_solve.c(51),1,3034,0.0006592,0,0,0.0001276,6.38E-05,0,0,1,1,0,0,0,0
/home/s1736883/Work/PParMetrics/benchmarks/snu-npb/nauseous-omp/SP/src/x_solve.c(61),0,222,0,0,0,0,0,0,0,0,0,0,0,0,0
/home/s1736883/Work/PParMetrics/benchmarks/snu-npb/nauseous-omp/SP/src/x_solve.c(80),1,144,0.8542,2,0.2927,0.3157,0.03226,0.1464,0.1464,239,176,63,140,77,63
/home/s1736883/Work/PParMetrics/benchmarks/snu-npb/nauseous-omp/SP/src/x_solve.c(92),1,111,0,0,0,0,0,0,0,0,0,0,0,0,0
/home/s1736883/Work/PParMetrics/benchmarks/snu-npb/nauseous-omp/SP/src/x_solve.c(102),1,144,0.8542,2,0.2927,0.3157,0.03226,0.1506,0.1506,239,176,63,140,77,63
/home/s1736883/Work/PParMetrics/benchmarks/snu-npb/nauseous-omp/SP/src/x_solve.c(118),1,236,0,0,0,0,0,0,0,0,0,0,0,0,0
/home/s1736883/Work/PParMetrics/benchmarks/snu-npb/nauseous-omp/SP/src/x_solve.c(140),1,365,0,0,0,0,0,0,0,0,0,0,0,0,0
/home/s1736883/Work/PParMetrics/benchmarks/snu-npb/nauseous-omp/SP/src/x_solve.c(168),1,274,0.5511,5,0.4702,0.2156,0.02187,0.07921,0.07921,404,256,148,314,166,148
/home/s1736883/Work/PParMetrics/benchmarks/snu-npb/nauseous-omp/SP/src/x_solve.c(195),1,645,0,0,0,0,0,0,0,0,0,0,0,0,0
/home/s1736883/Work/PParMetrics/benchmarks/snu-npb/nauseous-omp/SP/src/x_solve.c(229),1,461,0.8894,5,0.322,0.3211,0.03112,0.1232,0.1232,812,600,212,476,264,212
/home/s1736883/Work/PParMetrics/benchmarks/snu-npb/nauseous-omp/SP/src/x_solve.c(261),1,160,0.6312,4,0.3366,0.3158,0.02632,0.1125,0.1125,160,120,40,88,48,40
/home/s1736883/Work/PParMetrics/benchmarks/snu-npb/nauseous-omp/SP/src/x_solve.c(275),1,237,0.08017,1,0.9474,0.01402,0.004673,0.01538,0.01538,65,33,32,64,32,32
/home/s1736883/Work/PParMetrics/benchmarks/snu-npb/nauseous-omp/SP/src/x_solve.c(62),1,122,0.9016,1,0.4727,0.2171,0.0155,0.1919,0.05814,172,102,12,102,55,12
/home/s1736883/Work/PParMetrics/benchmarks/snu-npb/nauseous-omp/SP/src/x_solve.c(68),1,87,0.8046,0,0,0.4233,0.05291,0,0,63,63,0,0,0,0
/home/s1736883/Work/PParMetrics/benchmarks/snu-npb/nauseous-omp/SP/src/x_solve.c(93),1,100,0.82,1,0.1829,0.3472,0.03774,0.12,0.12,125,100,25,60,35,25
/home/s1736883/Work/PParMetrics/benchmarks/snu-npb/nauseous-omp/SP/src/x_solve.c(119),1,225,0.8622,0,0,0.4467,0.04918,0,0,182,182,0,0,0,0
/home/s1736883/Work/PParMetrics/benchmarks/snu-npb/nauseous-omp/SP/src/x_solve.c(141),0,354,0.596,4,0.3697,0.2261,0.01269,0.06014,0.06014,582,375,207,442,235,207
/home/s1736883/Work/PParMetrics/benchmarks/snu-npb/nauseous-omp/SP/src/x_solve.c(174),1,36,0.7778,1,0.1071,0.3896,0.02597,0.1111,0.1111,27,26,1,4,3,1
/home/s1736883/Work/PParMetrics/benchmarks/snu-npb/nauseous-omp/SP/src/x_solve.c(179),1,57,0.8421,1,0.1042,0.4146,0.02439,0.08163,0.08163,49,47,2,8,6,2
/home/s1736883/Work/PParMetrics/benchmarks/snu-npb/nauseous-omp/SP/src/x_solve.c(187),1,36,0.7778,1,0.1071,0.3896,0.02597,0.1111,0.1111,27,26,1,4,3,1
/home/s1736883/Work/PParMetrics/benchmarks/snu-npb/nauseous-omp/SP/src/x_solve.c(196),0,634,0.9432,5,0.2642,0.3149,0.01408,0.09206,0.09206,1260,916,344,764,420,344
/home/s1736883/Work/PParMetrics/benchmarks/snu-npb/nauseous-omp/SP/src/x_solve.c(264),1,57,0.8421,1,0.1042,0.4146,0.02439,0.08163,0.08163,49,47,2,8,6,2
/home/s1736883/Work/PParMetrics/benchmarks/snu-npb/nauseous-omp/SP/src/x_solve.c(276),0,224,0.4464,3,0.28,0.31,0.075,0.1026,0.1026,156,123,33,80,47,33
/home/s1736883/Work/PParMetrics/benchmarks/snu-npb/nauseous-omp/SP/src/x_solve.c(147),1,36,0.7778,1,0.1071,0.3896,0.02597,0.1111,0.1111,27,26,1,4,3,1
/home/s1736883/Work/PParMetrics/benchmarks/snu-npb/nauseous-omp/SP/src/x_solve.c(152),1,57,0.8421,1,0.1042,0.4146,0.02439,0.08163,0.08163,49,47,2,8,6,2
/home/s1736883/Work/PParMetrics/benchmarks/snu-npb/nauseous-omp/SP/src/x_solve.c(157),1,57,0.8421,1,0.1042,0.4146,0.02439,0.08163,0.08163,49,47,2,8,6,2
/home/s1736883/Work/PParMetrics/benchmarks/snu-npb/nauseous-omp/SP/src/x_solve.c(279),1,80,0.875,1,0.1143,0.4277,0.02312,0.08219,0.08219,73,70,3,13,10,3
/home/s1736883/Work/PParMetrics/benchmarks/snu-npb/nauseous-omp/SP/src/y_solve.c(51),1,3047,0.09485,2,0.9689,0.0009239,0.0002867,0.0008856,0.0008856,7904,3956,3948,7896,3948,3948
/home/s1736883/Work/PParMetrics/benchmarks/snu-npb/nauseous-omp/SP/src/y_solve.c(61),0,224,0.1161,1,0.8462,0.02778,0,0,0,144,72,72,144,72,72
/home/s1736883/Work/PParMetrics/benchmarks/snu-npb/nauseous-omp/SP/src/y_solve.c(80),1,145,0.8483,2,0.2927,0.3142,0.03211,0.1464,0.1464,239,176,63,140,77,63
/home/s1736883/Work/PParMetrics/benchmarks/snu-npb/nauseous-omp/SP/src/y_solve.c(92),1,112,0,0,0,0,0,0,0,0,0,0,0,0,0
/home/s1736883/Work/PParMetrics/benchmarks/snu-npb/nauseous-omp/SP/src/y_solve.c(102),1,145,0.8483,2,0.2927,0.3142,0.03211,0.1506,0.1506,239,176,63,140,77,63
/home/s1736883/Work/PParMetrics/benchmarks/snu-npb/nauseous-omp/SP/src/y_solve.c(117),1,238,0,0,0,0,0,0,0,0,0,0,0,0,0
/home/s1736883/Work/PParMetrics/benchmarks/snu-npb/nauseous-omp/SP/src/y_solve.c(136),0,366,0.1639,3,0.9167,0.01567,0.003135,0.01176,0.01176,170,86,84,168,84,84
/home/s1736883/Work/PParMetrics/benchmarks/snu-npb/nauseous-omp/SP/src/y_solve.c(166),1,269,0.316,2,0.3294,0.1871,0.04762,0.09302,0.09302,172,124,48,114,66,48
/home/s1736883/Work/PParMetrics/benchmarks/snu-npb/nauseous-omp/SP/src/y_solve.c(190),0,646,0.05882,2,1,0.003876,0.001938,0,0,72,36,36,72,36,36
/home/s1736883/Work/PParMetrics/benchmarks/snu-npb/nauseous-omp/SP/src/y_solve.c(225),1,456,0.886,3,0.2129,0.3399,0.03338,0.075,0.075,720,552,168,388,220,168
/home/s1736883/Work/PParMetrics/benchmarks/snu-npb/nauseous-omp/SP/src/y_solve.c(257),1,155,0.5871,2,0.2198,0.3309,0.02941,0.06061,0.06061,132,104,28,64,36,28
/home/s1736883/Work/PParMetrics/benchmarks/snu-npb/nauseous-omp/SP/src/y_solve.c(269),0,236,0.0339,2,1,0.0177,0.00885,0,0,12,6,6,12,6,6
/home/s1736883/Work/PParMetrics/benchmarks/snu-npb/nauseous-omp/SP/src/y_solve.c(62),1,122,0.9016,1,0.4727,0.2171,0.0155,0.1919,0.05814,172,102,12,102,55,12
/home/s1736883/Work/PParMetrics/benchmarks/snu-npb/nauseous-omp/SP/src/y_solve.c(68),1,88,0.7955,0,0,0.4188,0.05236,0,0,63,63,0,0,0,0
/home/s1736883/Work/PParMetrics/benchmarks/snu-npb/nauseous-omp/SP/src/y_solve.c(93),1,100,0.82,1,0.1829,0.3472,0.03774,0.12,0.12,125,100,25,60,35,25
/home/s1736883/Work/PParMetrics/benchmarks/snu-npb/nauseous-omp/SP/src/y_solve.c(118),1,226,0.8584,0,0,0.4449,0.04898,0,0,182,182,0,0,0,0
/home/s1736883/Work/PParMetrics/benchmarks/snu-npb/nauseous-omp/SP/src/y_solve.c(139),1,348,0.5431,2,0.3069,0.2227,0.02462,0.03947,0.03947,532,343,189,406,217,189
/home/s1736883/Work/PParMetrics/benchmarks/snu-npb/nauseous-omp/SP/src/y_solve.c(170),1,36,0.7778,1,0.1071,0.3896,0.02597,0.1111,0.1111,27,26,1,4,3,1
/home/s1736883/Work/PParMetrics/benchmarks/snu-npb/nauseous-omp/SP/src/y_solve.c(175),1,57,0.8421,1,0.1042,0.4146,0.02439,0.08163,0.08163,49,47,2,8,6,2
/home/s1736883/Work/PParMetrics/benchmarks/snu-npb/nauseous-omp/SP/src/y_solve.c(182),1,36,0.7778,1,0.1071,0.3896,0.02597,0.1111,0.1111,27,26,1,4,3,1
/home/s1736883/Work/PParMetrics/benchmarks/snu-npb/nauseous-omp/SP/src/y_solve.c(193),1,628,0.8885,3,0.2151,0.3141,0.03141,0.06783,0.06783,1150,842,308,692,384,308
/home/s1736883/Work/PParMetrics/benchmarks/snu-npb/nauseous-omp/SP/src/y_solve.c(258),1,57,0.8421,1,0.1042,0.4146,0.02439,0.08163,0.08163,49,47,2,8,6,2
/home/s1736883/Work/PParMetrics/benchmarks/snu-npb/nauseous-omp/SP/src/y_solve.c(272),1,220,0.4,1,0.2273,0.2974,0.08205,0.08824,0.08824,136,109,27,68,41,27
/home/s1736883/Work/PParMetrics/benchmarks/snu-npb/nauseous-omp/SP/src/y_solve.c(143),1,36,0.7778,1,0.1071,0.3896,0.02597,0.1111,0.1111,27,26,1,4,3,1
/home/s1736883/Work/PParMetrics/benchmarks/snu-npb/nauseous-omp/SP/src/y_solve.c(148),1,57,0.8421,1,0.1042,0.4146,0.02439,0.08163,0.08163,49,47,2,8,6,2
/home/s1736883/Work/PParMetrics/benchmarks/snu-npb/nauseous-omp/SP/src/y_solve.c(153),1,57,0.8421,1,0.1042,0.4146,0.02439,0.08163,0.08163,49,47,2,8,6,2
/home/s1736883/Work/PParMetrics/benchmarks/snu-npb/nauseous-omp/SP/src/y_solve.c(273),1,80,0.875,1,0.1143,0.4277,0.02312,0.08219,0.08219,73,70,3,13,10,3
/home/s1736883/Work/PParMetrics/benchmarks/snu-npb/nauseous-omp/SP/src/z_solve.c(55),1,3023,0.09626,2,0.9691,0.0009025,0.0002801,0.0008094,0.0008094,8648,4328,4320,8640,4320,4320
/home/s1736883/Work/PParMetrics/benchmarks/snu-npb/nauseous-omp/SP/src/z_solve.c(65),0,222,0,0,0,0,0,0,0,0,0,0,0,0,0
/home/s1736883/Work/PParMetrics/benchmarks/snu-npb/nauseous-omp/SP/src/z_solve.c(84),1,137,0.8467,2,0.319,0.2908,0.03132,0.1351,0.1351,259,182,77,168,91,77
/home/s1736883/Work/PParMetrics/benchmarks/snu-npb/nauseous-omp/SP/src/z_solve.c(97),1,111,0,0,0,0,0,0,0,0,0,0,0,0,0
/home/s1736883/Work/PParMetrics/benchmarks/snu-npb/nauseous-omp/SP/src/z_solve.c(107),1,140,0.85,2,0.3109,0.2936,0.03091,0.1412,0.1412,262,185,77,168,91,77
/home/s1736883/Work/PParMetrics/benchmarks/snu-npb/nauseous-omp/SP/src/z_solve.c(123),1,236,0.1314,1,0.9032,0.02326,0,0,0,104,52,52,104,52,52
/home/s1736883/Work/PParMetrics/benchmarks/snu-npb/nauseous-omp/SP/src/z_solve.c(142),0,365,0.05479,2,1,0.00627,0.003135,0,0,36,18,18,36,18,18
/home/s1736883/Work/PParMetrics/benchmarks/snu-npb/nauseous-omp/SP/src/z_solve.c(172),1,268,0.3172,2,0.3294,0.1877,0.04778,0.09302,0.09302,172,124,48,114,66,48
/home/s1736883/Work/PParMetrics/benchmarks/snu-npb/nauseous-omp/SP/src/z_solve.c(197),0,645,0.05891,2,1,0.003876,0.001938,0,0,72,36,36,72,36,36
/home/s1736883/Work/PParMetrics/benchmarks/snu-npb/nauseous-omp/SP/src/z_solve.c(232),1,455,0.8879,3,0.2129,0.3404,0.03343,0.075,0.075,720,552,168,388,220,168
/home/s1736883/Work/PParMetrics/benchmarks/snu-npb/nauseous-omp/SP/src/z_solve.c(265),1,154,0.5909,2,0.2198,0.3333,0.02963,0.06061,0.06061,132,104,28,64,36,28
/home/s1736883/Work/PParMetrics/benchmarks/snu-npb/nauseous-omp/SP/src/z_solve.c(282),0,235,0.03404,2,1,0.0177,0.00885,0,0,12,6,6,12,6,6
/home/s1736883/Work/PParMetrics/benchmarks/snu-npb/nauseous-omp/SP/src/z_solve.c(66),1,122,0.9016,1,0.4727,0.2171,0.0155,0.1919,0.05814,172,102,12,102,55,12
/home/s1736883/Work/PParMetrics/benchmarks/snu-npb/nauseous-omp/SP/src/z_solve.c(72),1,87,0.8046,0,0,0.4233,0.05291,0,0,63,63,0,0,0,0
/home/s1736883/Work/PParMetrics/benchmarks/snu-npb/nauseous-omp/SP/src/z_solve.c(98),1,99,0.8283,1,0.1829,0.3498,0.03802,0.12,0.12,125,100,25,60,35,25
/home/s1736883/Work/PParMetrics/benchmarks/snu-npb/nauseous-omp/SP/src/z_solve.c(124),1,225,0.8622,0,0,0.4467,0.04918,0,0,182,182,0,0,0,0
/home/s1736883/Work/PParMetrics/benchmarks/snu-npb/nauseous-omp/SP/src/z_solve.c(145),1,347,0.5447,2,0.3069,0.2233,0.02468,0.03947,0.03947,532,343,189,406,217,189
/home/s1736883/Work/PParMetrics/benchmarks/snu-npb/nauseous-omp/SP/src/z_solve.c(176),1,36,0.7778,1,0.1071,0.3896,0.02597,0.1111,0.1111,27,26,1,4,3,1
/home/s1736883/Work/PParMetrics/benchmarks/snu-npb/nauseous-omp/SP/src/z_solve.c(181),1,57,0.8421,1,0.1042,0.4146,0.02439,0.08163,0.08163,49,47,2,8,6,2
/home/s1736883/Work/PParMetrics/benchmarks/snu-npb/nauseous-omp/SP/src/z_solve.c(189),1,36,0.7778,1,0.1071,0.3896,0.02597,0.1111,0.1111,27,26,1,4,3,1
/home/s1736883/Work/PParMetrics/benchmarks/snu-npb/nauseous-omp/SP/src/z_solve.c(200),1,627,0.89,3,0.2151,0.3144,0.03144,0.06783,0.06783,1150,842,308,692,384,308
/home/s1736883/Work/PParMetrics/benchmarks/snu-npb/nauseous-omp/SP/src/z_solve.c(266),1,57,0.8421,1,0.1042,0.4146,0.02439,0.08163,0.08163,49,47,2,8,6,2
/home/s1736883/Work/PParMetrics/benchmarks/snu-npb/nauseous-omp/SP/src/z_solve.c(285),1,219,0.4018,1,0.2273,0.299,0.08247,0.08824,0.08824,136,109,27,68,41,27
/home/s1736883/Work/PParMetrics/benchmarks/snu-npb/nauseous-omp/SP/src/z_solve.c(149),1,36,0.7778,1,0.1071,0.3896,0.02597,0.1111,0.1111,27,26,1,4,3,1
/home/s1736883/Work/PParMetrics/benchmarks/snu-npb/nauseous-omp/SP/src/z_solve.c(154),1,57,0.8421,1,0.1042,0.4146,0.02439,0.08163,0.08163,49,47,2,8,6,2
/home/s1736883/Work/PParMetrics/benchmarks/snu-npb/nauseous-omp/SP/src/z_solve.c(159),1,57,0.8421,1,0.1042,0.4146,0.02439,0.08163,0.08163,49,47,2,8,6,2
/home/s1736883/Work/PParMetrics/benchmarks/snu-npb/nauseous-omp/SP/src/z_solve.c(286),1,80,0.875,1,0.1143,0.4277,0.02312,0.08219,0.08219,73,70,3,13,10,3
/home/s1736883/Work/PParMetrics/benchmarks/snu-npb/nauseous-omp/UA/src/adapt.c(149),1,19,0.5263,1,0.2,0.2857,0.04762,0.25,0.25,8,7,1,2,1,1
/home/s1736883/Work/PParMetrics/benchmarks/snu-npb/nauseous-omp/UA/src/adapt.c(113),1,13,0.3846,0,0,0.2222,0.03704,0,0,2,2,0,0,0,0
/home/s1736883/Work/PParMetrics/benchmarks/snu-npb/nauseous-omp/UA/src/adapt.c(91),0,5,0.4,0,0,0.2857,0,0,0,0,0,0,0,0,0
/home/s1736883/Work/PParMetrics/benchmarks/snu-npb/nauseous-omp/UA/src/adapt.c(399),1,1479,0.3144,20,0.772,0.01753,0.0001013,0.005944,0.005944,8075,4095,3980,7964,3984,3980
/home/s1736883/Work/PParMetrics/benchmarks/snu-npb/nauseous-omp/UA/src/adapt.c(407),1,41,0.7073,0,0,0.3846,0.06593,0,0,24,24,0,0,0,0
/home/s1736883/Work/PParMetrics/benchmarks/snu-npb/nauseous-omp/UA/src/adapt.c(412),1,62,0.2903,1,0.3333,0.1899,0.02532,0,0,24,16,8,16,8,8
/home/s1736883/Work/PParMetrics/benchmarks/snu-npb/nauseous-omp/UA/src/adapt.c(430),0,57,0.7719,0,0,0.418,0.05738,0,0,36,36,0,0,0,0
/home/s1736883/Work/PParMetrics/benchmarks/snu-npb/nauseous-omp/UA/src/adapt.c(442),1,19,0.5789,0,0,0.3171,0.04878,0,0,8,8,0,0,0,0
/home/s1736883/Work/PParMetrics/benchmarks/snu-npb/nauseous-omp/UA/src/adapt.c(470),1,25,0.68,0,0,0.3654,0.03846,0,0,13,13,0,0,0,0
/home/s1736883/Work/PParMetrics/benchmarks/snu-npb/nauseous-omp/UA/src/adapt.c(475),1,65,0.8154,0,0,0.4338,0.04412,0,0,45,45,0,0,0,0
/home/s1736883/Work/PParMetrics/benchmarks/snu-npb/nauseous-omp/UA/src/adapt.c(483),1,65,0.8154,0,0,0.4338,0.04412,0,0,45,45,0,0,0,0
/home/s1736883/Work/PParMetrics/benchmarks/snu-npb/nauseous-omp/UA/src/adapt.c(491),1,116,0,0,0,0,0,0,0,0,0,0,0,0,0
/home/s1736883/Work/PParMetrics/benchmarks/snu-npb/nauseous-omp/UA/src/adapt.c(506),1,25,0.68,0,0,0.3654,0.03846,0,0,13,13,0,0,0,0
/home/s1736883/Work/PParMetrics/benchmarks/snu-npb/nauseous-omp/UA/src/adapt.c(510),1,25,0.68,0,0,0.3654,0.03846,0,0,13,13,0,0,0,0
/home/s1736883/Work/PParMetrics/benchmarks/snu-npb/nauseous-omp/UA/src/adapt.c(515),1,39,0,0,0,0,0,0,0,0,0,0,0,0,0
/home/s1736883/Work/PParMetrics/benchmarks/snu-npb/nauseous-omp/UA/src/adapt.c(521),1,39,0.2308,1,0.6667,0.1053,0,0,0,16,8,8,16,8,8
/home/s1736883/Work/PParMetrics/benchmarks/snu-npb/nauseous-omp/UA/src/adapt.c(527),1,25,0.68,0,0,0.3654,0.03846,0,0,13,13,0,0,0,0
/home/s1736883/Work/PParMetrics/benchmarks/snu-npb/nauseous-omp/UA/src/adapt.c(539),0,618,0,0,0,0,0,0,0,0,0,0,0,0,0
/home/s1736883/Work/PParMetrics/benchmarks/snu-npb/nauseous-omp/UA/src/adapt.c(414),1,41,0,0,0,0,0,0,0,0,0,0,0,0,0
/home/s1736883/Work/PParMetrics/benchmarks/snu-npb/nauseous-omp/UA/src/adapt.c(457),1,29,0.7241,0,0,0.3833,0.03333,0,0,17,17,0,0,0,0
/home/s1736883/Work/PParMetrics/benchmarks/snu-npb/nauseous-omp/UA/src/adapt.c(464),1,29,0.7241,0,0,0.3833,0.03333,0,0,17,17,0,0,0,0
/home/s1736883/Work/PParMetrics/benchmarks/snu-npb/nauseous-omp/UA/src/adapt.c(492),1,52,0.8077,0,0,0.4259,0.03704,0,0,36,36,0,0,0,0
/home/s1736883/Work/PParMetrics/benchmarks/snu-npb/nauseous-omp/UA/src/adapt.c(498),1,52,0.8077,0,0,0.4259,0.03704,0,0,36,36,0,0,0,0
/home/s1736883/Work/PParMetrics/benchmarks/snu-npb/nauseous-omp/UA/src/adapt.c(516),1,29,0.7241,0,0,0.3833,0.03333,0,0,17,17,0,0,0,0
/home/s1736883/Work/PParMetrics/benchmarks/snu-npb/nauseous-omp/UA/src/adapt.c(522),1,29,0.7241,0,0,0.3833,0.03333,0,0,17,17,0,0,0,0
/home/s1736883/Work/PParMetrics/benchmarks/snu-npb/nauseous-omp/UA/src/adapt.c(540),0,608,0.3783,7,0.7826,0.01206,0.001645,0.03237,0.01022,1761,873,818,1658,831,818
/home/s1736883/Work/PParMetrics/benchmarks/snu-npb/nauseous-omp/UA/src/adapt.c(415),1,31,0.7419,0,0,0.3846,0.03077,0,0,20,20,0,0,0,0
/home/s1736883/Work/PParMetrics/benchmarks/snu-npb/nauseous-omp/UA/src/adapt.c(547),1,41,0.7561,0,0,0.3977,0.04545,0,0,27,27,0,0,0,0
/home/s1736883/Work/PParMetrics/benchmarks/snu-npb/nauseous-omp/UA/src/adapt.c(558),0,56,0.8036,0,0,0.4237,0.04237,0,0,39,39,0,0,0,0
/home/s1736883/Work/PParMetrics/benchmarks/snu-npb/nauseous-omp/UA/src/adapt.c(633),0,19,0.6316,0,0,0.3333,0.02564,0,0,9,9,0,0,0,0
/home/s1736883/Work/PParMetrics/benchmarks/snu-npb/nauseous-omp/UA/src/adapt.c(601),0,63,0.8413,1,0.1321,0.4,0.02963,0.07273,0.05455,55,48,4,13,7,4
/home/s1736883/Work/PParMetrics/benchmarks/snu-npb/nauseous-omp/UA/src/adapt.c(369),1,55,0.5636,2,0.2581,0.2803,0.04545,0.2162,0.2162,37,29,8,16,8,8
/home/s1736883/Work/PParMetrics/benchmarks/snu-npb/nauseous-omp/UA/src/adapt.c(358),1,30,0.3333,0,0,0.1875,0.03125,0,0,6,6,0,0,0,0
/home/s1736883/Work/PParMetrics/benchmarks/snu-npb/nauseous-omp/UA/src/adapt.c(338),1,44,0.2955,0,0,0.1633,0.03061,0,0,6,6,0,0,0,0
/home/s1736883/Work/PParMetrics/benchmarks/snu-npb/nauseous-omp/UA/src/adapt.c(301),1,91,0.9121,5,0.1687,0.4398,0.005236,0.2386,0.2386,88,79,9,18,9,9
/home/s1736883/Work/PParMetrics/benchmarks/snu-npb/nauseous-omp/UA/src/adapt.c(286),1,60,0.4833,1,0.1034,0.2687,0.05224,0.125,0.125,24,22,2,4,2,2
/home/s1736883/Work/PParMetrics/benchmarks/snu-npb/nauseous-omp/UA/src/adapt.c(204),1,258,0.1667,2,0.6512,0.02673,0.001215,0.003096,0.003096,323,162,161,322,161,161
/home/s1736883/Work/PParMetrics/benchmarks/snu-npb/nauseous-omp/UA/src/adapt.c(231),1,21,0.6667,0,0,0.3171,0.02439,0,0,11,9,0,0,0,0
/home/s1736883/Work/PParMetrics/benchmarks/snu-npb/nauseous-omp/UA/src/adapt.c(238),1,19,0.6316,0,0,0.2973,0.02703,0,0,9,7,0,0,0,0
/home/s1736883/Work/PParMetrics/benchmarks/snu-npb/nauseous-omp/UA/src/adapt.c(245),1,18,0.5556,0,0,0.2703,0.05405,0,0,7,5,0,0,0,0
/home/s1736883/Work/PParMetrics/benchmarks/snu-npb/nauseous-omp/UA/src/adapt.c(261),0,15,0.5333,0,0,0.2903,0.03226,0,0,5,5,0,0,0,0
/home/s1736883/Work/PParMetrics/benchmarks/snu-npb/nauseous-omp/UA/src/adapt.c(265),0,16,0.5625,0,0,0.303,0.0303,0,0,6,6,0,0,0,0
/home/s1736883/Work/PParMetrics/benchmarks/snu-npb/nauseous-omp/UA/src/adapt.c(195),1,13,0.3846,0,0,0.2222,0.03704,0,0,2,2,0,0,0,0
/home/s1736883/Work/PParMetrics/benchmarks/snu-npb/nauseous-omp/UA/src/adapt.c(190),1,21,0.5238,1,0.1818,0.2917,0.0625,0.3333,0.3333,9,8,1,2,1,1
/home/s1736883/Work/PParMetrics/benchmarks/snu-npb/nauseous-omp/UA/src/adapt.c(1002),0,435,0.07816,1,0.6176,0.01485,0,0,0,136,68,68,136,68,68
/home/s1736883/Work/PParMetrics/benchmarks/snu-npb/nauseous-omp/UA/src/adapt.c(1005),1,23,0.6522,0,0,0.3469,0.04082,0,0,12,12,0,0,0,0
/home/s1736883/Work/PParMetrics/benchmarks/snu-npb/nauseous-omp/UA/src/adapt.c(1026),0,120,0.8583,1,0.1359,0.4254,0.04104,0.1215,0.1215,107,100,7,22,15,7
/home/s1736883/Work/PParMetrics/benchmarks/snu-npb/nauseous-omp/UA/src/adapt.c(997),1,16,0.5625,0,0,0.303,0.0303,0,0,6,6,0,0,0,0
/home/s1736883/Work/PParMetrics/benchmarks/snu-npb/nauseous-omp/UA/src/adapt.c(994),1,16,0.5625,0,0,0.303,0.0303,0,0,6,6,0,0,0,0
/home/s1736883/Work/PParMetrics/benchmarks/snu-npb/nauseous-omp/UA/src/adapt.c(990),1,25,0.68,0,0,0.3654,0.03846,0,0,13,13,0,0,0,0
/home/s1736883/Work/PParMetrics/benchmarks/snu-npb/nauseous-omp/UA/src/adapt.c(986),1,25,0.68,0,0,0.3654,0.03846,0,0,13,13,0,0,0,0
/home/s1736883/Work/PParMetrics/benchmarks/snu-npb/nauseous-omp/UA/src/adapt.c(983),1,16,0.5625,0,0,0.303,0.0303,0,0,6,6,0,0,0,0
/home/s1736883/Work/PParMetrics/benchmarks/snu-npb/nauseous-omp/UA/src/adapt.c(980),1,16,0.5625,0,0,0.303,0.0303,0,0,6,6,0,0,0,0
/home/s1736883/Work/PParMetrics/benchmarks/snu-npb/nauseous-omp/UA/src/adapt.c(931),0,388,0,0,0,0,0,0,0,0,0,0,0,0,0
/home/s1736883/Work/PParMetrics/benchmarks/snu-npb/nauseous-omp/UA/src/adapt.c(932),0,378,0,0,0,0,0,0,0,0,0,0,0,0,0
/home/s1736883/Work/PParMetrics/benchmarks/snu-npb/nauseous-omp/UA/src/adapt.c(933),0,368,0,0,0,0,0,0,0,0,0,0,0,0,0
/home/s1736883/Work/PParMetrics/benchmarks/snu-npb/nauseous-omp/UA/src/adapt.c(934),0,358,0.9162,1,0.1463,0.3088,0.02105,0.04558,0.04558,702,510,192,424,232,192
/home/s1736883/Work/PParMetrics/benchmarks/snu-npb/nauseous-omp/UA/src/adapt.c(905),1,320,0.075,1,0.8333,0.00974,0,0,0,128,64,64,128,64,64
/home/s1736883/Work/PParMetrics/benchmarks/snu-npb/nauseous-omp/UA/src/adapt.c(906),0,112,0,0,0,0,0,0,0,0,0,0,0,0,0
/home/s1736883/Work/PParMetrics/benchmarks/snu-npb/nauseous-omp/UA/src/adapt.c(915),0,196,0,0,0,0,0,0,0,0,0,0,0,0,0
/home/s1736883/Work/PParMetrics/benchmarks/snu-npb/nauseous-omp/UA/src/adapt.c(907),1,102,0.1275,1,0.7692,0.05128,0,0,0,32,16,16,32,16,16
/home/s1736883/Work/PParMetrics/benchmarks/snu-npb/nauseous-omp/UA/src/adapt.c(916),1,186,0,0,0,0,0,0,0,0,0,0,0,0,0
/home/s1736883/Work/PParMetrics/benchmarks/snu-npb/nauseous-omp/UA/src/adapt.c(908),1,92,0.8696,1,0.125,0.4095,0.02857,0.08696,0.08696,92,84,8,24,16,8
/home/s1736883/Work/PParMetrics/benchmarks/snu-npb/nauseous-omp/UA/src/adapt.c(917),1,176,0.8977,1,0.07595,0.4208,0.0297,0.06522,0.06522,184,168,16,40,24,16
/home/s1736883/Work/PParMetrics/benchmarks/snu-npb/nauseous-omp/UA/src/convect.c(247),1,22,0.5455,1,0.25,0.2941,0.05882,0.2727,0.2727,11,10,1,4,3,1
/home/s1736883/Work/PParMetrics/benchmarks/snu-npb/nauseous-omp/UA/src/convect.c(73),1,1380,0.01159,1,0.875,0.0004581,0.0001145,0.03571,0.03571,28,15,13,26,13,13
/home/s1736883/Work/PParMetrics/benchmarks/snu-npb/nauseous-omp/UA/src/convect.c(80),1,34,0.7647,0,0,0.3944,0.02817,0,0,23,23,0,0,0,0
/home/s1736883/Work/PParMetrics/benchmarks/snu-npb/nauseous-omp/UA/src/convect.c(83),1,34,0.7647,0,0,0.3944,0.02817,0,0,23,23,0,0,0,0
/home/s1736883/Work/PParMetrics/benchmarks/snu-npb/nauseous-omp/UA/src/convect.c(86),1,34,0.7647,0,0,0.3944,0.02817,0,0,23,23,0,0,0,0
/home/s1736883/Work/PParMetrics/benchmarks/snu-npb/nauseous-omp/UA/src/convect.c(90),1,278,0,0,0,0,0,0,0,0,0,0,0,0,0
/home/s1736883/Work/PParMetrics/benchmarks/snu-npb/nauseous-omp/UA/src/convect.c(122),1,269,0,0,0,0,0,0,0,0,0,0,0,0,0
/home/s1736883/Work/PParMetrics/benchmarks/snu-npb/nauseous-omp/UA/src/convect.c(154),1,269,0,0,0,0,0,0,0,0,0,0,0,0,0
/home/s1736883/Work/PParMetrics/benchmarks/snu-npb/nauseous-omp/UA/src/convect.c(186),1,289,0,0,0,0,0,0,0,0,0,0,0,0,0
/home/s1736883/Work/PParMetrics/benchmarks/snu-npb/nauseous-omp/UA/src/convect.c(220),0,21,0.2381,0,0,0.1395,0.02326,0,0,1,1,0,0,0,0
/home/s1736883/Work/PParMetrics/benchmarks/snu-npb/nauseous-omp/UA/src/convect.c(226),1,120,0,0,0,0,0,0,0,0,0,0,0,0,0
/home/s1736883/Work/PParMetrics/benchmarks/snu-npb/nauseous-omp/UA/src/convect.c(91),1,268,0,0,0,0,0,0,0,0,0,0,0,0,0
/home/s1736883/Work/PParMetrics/benchmarks/snu-npb/nauseous-omp/UA/src/convect.c(123),1,259,0,0,0,0,0,0,0,0,0,0,0,0,0
/home/s1736883/Work/PParMetrics/benchmarks/snu-npb/nauseous-omp/UA/src/convect.c(155),1,259,0,0,0,0,0,0,0,0,0,0,0,0,0
/home/s1736883/Work/PParMetrics/benchmarks/snu-npb/nauseous-omp/UA/src/convect.c(187),1,279,0,0,0,0,0,0,0,0,0,0,0,0,0
/home/s1736883/Work/PParMetrics/benchmarks/snu-npb/nauseous-omp/UA/src/convect.c(227),1,110,0,0,0,0,0,0,0,0,0,0,0,0,0
/home/s1736883/Work/PParMetrics/benchmarks/snu-npb/nauseous-omp/UA/src/convect.c(92),1,258,0.655,8,0.2722,0.2616,0.01434,0.06793,0.04891,368,242,116,235,118,116
/home/s1736883/Work/PParMetrics/benchmarks/snu-npb/nauseous-omp/UA/src/convect.c(124),1,249,0.4056,6,0.1584,0.2276,0.06452,0.181,0.1207,116,98,8,19,10,8
/home/s1736883/Work/PParMetrics/benchmarks/snu-npb/nauseous-omp/UA/src/convect.c(156),1,249,0.6787,8,0.2722,0.2616,0.01434,0.06793,0.04891,368,242,116,235,118,116
/home/s1736883/Work/PParMetrics/benchmarks/snu-npb/nauseous-omp/UA/src/convect.c(188),1,269,0.6952,8,0.246,0.2757,0.01661,0.06477,0.04663,386,260,116,235,118,116
/home/s1736883/Work/PParMetrics/benchmarks/snu-npb/nauseous-omp/UA/src/convect.c(228),1,100,0.87,1,0.04598,0.4352,0.03241,0.05747,0.05747,87,85,2,6,4,2
/home/s1736883/Work/PParMetrics/benchmarks/snu-npb/nauseous-omp/UA/src/convect.c(101),1,32,0.75,1,0.125,0.3768,0.02899,0.04348,0.04348,23,22,1,4,3,1
/home/s1736883/Work/PParMetrics/benchmarks/snu-npb/nauseous-omp/UA/src/convect.c(106),1,32,0.75,1,0.125,0.3768,0.02899,0.04348,0.04348,23,22,1,4,3,1
/home/s1736883/Work/PParMetrics/benchmarks/snu-npb/nauseous-omp/UA/src/convect.c(111),1,32,0.75,1,0.125,0.3768,0.02899,0.04348,0.04348,23,22,1,4,3,1
/home/s1736883/Work/PParMetrics/benchmarks/snu-npb/nauseous-omp/UA/src/convect.c(133),1,29,0.7241,1,0.1429,0.3651,0.03175,0.05,0.05,20,19,1,4,3,1
/home/s1736883/Work/PParMetrics/benchmarks/snu-npb/nauseous-omp/UA/src/convect.c(138),1,29,0.7241,1,0.1429,0.3651,0.03175,0.05,0.05,20,19,1,4,3,1
/home/s1736883/Work/PParMetrics/benchmarks/snu-npb/nauseous-omp/UA/src/convect.c(143),1,29,0.7241,1,0.1429,0.3651,0.03175,0.05,0.05,20,19,1,4,3,1
/home/s1736883/Work/PParMetrics/benchmarks/snu-npb/nauseous-omp/UA/src/convect.c(165),1,29,0.7241,1,0.1429,0.3651,0.03175,0.05,0.05,20,19,1,4,3,1
/home/s1736883/Work/PParMetrics/benchmarks/snu-npb/nauseous-omp/UA/src/convect.c(170),1,29,0.7241,1,0.1429,0.3651,0.03175,0.05,0.05,20,19,1,4,3,1
/home/s1736883/Work/PParMetrics/benchmarks/snu-npb/nauseous-omp/UA/src/convect.c(175),1,29,0.7241,1,0.1429,0.3651,0.03175,0.05,0.05,20,19,1,4,3,1
/home/s1736883/Work/PParMetrics/benchmarks/snu-npb/nauseous-omp/UA/src/convect.c(197),1,29,0.7241,1,0.1429,0.3651,0.03175,0.05,0.05,20,19,1,4,3,1
/home/s1736883/Work/PParMetrics/benchmarks/snu-npb/nauseous-omp/UA/src/convect.c(202),1,29,0.7241,1,0.1429,0.3651,0.03175,0.05,0.05,20,19,1,4,3,1
/home/s1736883/Work/PParMetrics/benchmarks/snu-npb/nauseous-omp/UA/src/convect.c(207),1,29,0.7241,1,0.1429,0.3651,0.03175,0.05,0.05,20,19,1,4,3,1
/home/s1736883/Work/PParMetrics/benchmarks/snu-npb/nauseous-omp/UA/src/convect.c(65),1,38,0.6842,0,0,0.3765,0.07059,0,0,21,21,0,0,0,0
/home/s1736883/Work/PParMetrics/benchmarks/snu-npb/nauseous-omp/UA/src/diffuse.c(92),1,412,0.2985,7,0.6098,0.04519,0.0009823,0.03448,0.01478,609,306,275,552,277,275
/home/s1736883/Work/PParMetrics/benchmarks/snu-npb/nauseous-omp/UA/src/diffuse.c(101),1,123,0,0,0,0,0,0,0,0,0,0,0,0,0
/home/s1736883/Work/PParMetrics/benchmarks/snu-npb/nauseous-omp/UA/src/diffuse.c(114),1,34,0.6471,2,0.2273,0.3375,0.0625,0.2273,0.2273,22,20,2,6,4,2
/home/s1736883/Work/PParMetrics/benchmarks/snu-npb/nauseous-omp/UA/src/diffuse.c(137),1,22,0.5455,0,0,0.3061,0.06122,0,0,9,9,0,0,0,0
/home/s1736883/Work/PParMetrics/benchmarks/snu-npb/nauseous-omp/UA/src/diffuse.c(149),1,35,0.2571,1,0.6667,0.1,0,0,0,16,8,8,16,8,8
/home/s1736883/Work/PParMetrics/benchmarks/snu-npb/nauseous-omp/UA/src/diffuse.c(163),1,83,0.1205,1,0.7,0.04545,0,0,0,20,10,10,20,10,10
/home/s1736883/Work/PParMetrics/benchmarks/snu-npb/nauseous-omp/UA/src/diffuse.c(175),1,34,0.6471,2,0.3182,0.3293,0.06098,0.25,0.25,24,21,3,10,7,3
/home/s1736883/Work/PParMetrics/benchmarks/snu-npb/nauseous-omp/UA/src/diffuse.c(102),1,112,0,0,0,0,0,0,0,0,0,0,0,0,0
/home/s1736883/Work/PParMetrics/benchmarks/snu-npb/nauseous-omp/UA/src/diffuse.c(150),0,24,0.3333,0,0,0.1837,0.02041,0,0,4,4,0,0,0,0
/home/s1736883/Work/PParMetrics/benchmarks/snu-npb/nauseous-omp/UA/src/diffuse.c(164),1,72,0.1389,1,0.7,0.06061,0,0,0,20,10,10,20,10,10
/home/s1736883/Work/PParMetrics/benchmarks/snu-npb/nauseous-omp/UA/src/diffuse.c(103),1,102,0,0,0,0,0,0,0,0,0,0,0,0,0
/home/s1736883/Work/PParMetrics/benchmarks/snu-npb/nauseous-omp/UA/src/diffuse.c(165),1,62,0,0,0,0,0,0,0,0,0,0,0,0,0
/home/s1736883/Work/PParMetrics/benchmarks/snu-npb/nauseous-omp/UA/src/diffuse.c(104),1,92,0.8696,2,0.0625,0.4343,0.0303,0.0625,0.0625,80,78,2,6,4,2
/home/s1736883/Work/PParMetrics/benchmarks/snu-npb/nauseous-omp/UA/src/diffuse.c(166),1,52,0.8269,1,0.06977,0.4144,0.02703,0.02381,0.02381,42,41,1,4,3,1
/home/s1736883/Work/PParMetrics/benchmarks/snu-npb/nauseous-omp/UA/src/diffuse.c(83),1,34,0.6471,2,0.2273,0.3375,0.0625,0.2273,0.2273,22,20,2,6,4,2
/home/s1736883/Work/PParMetrics/benchmarks/snu-npb/nauseous-omp/UA/src/diffuse.c(70),1,123,0,0,0,0,0,0,0,0,0,0,0,0,0
/home/s1736883/Work/PParMetrics/benchmarks/snu-npb/nauseous-omp/UA/src/diffuse.c(71),1,112,0,0,0,0,0,0,0,0,0,0,0,0,0
/home/s1736883/Work/PParMetrics/benchmarks/snu-npb/nauseous-omp/UA/src/diffuse.c(72),1,102,0.1275,1,0.7692,0.06061,0,0,0,32,16,16,32,16,16
/home/s1736883/Work/PParMetrics/benchmarks/snu-npb/nauseous-omp/UA/src/diffuse.c(73),1,92,0.8696,2,0.0625,0.4343,0.0303,0.0625,0.0625,80,78,2,6,4,2
/home/s1736883/Work/PParMetrics/benchmarks/snu-npb/nauseous-omp/UA/src/diffuse.c(57),1,13,0.3846,0,0,0.2222,0.03704,0,0,2,2,0,0,0,0
/home/s1736883/Work/PParMetrics/benchmarks/snu-npb/nauseous-omp/UA/src/diffuse.c(246),0,143,0,0,0,0,0,0,0,0,0,0,0,0,0
/home/s1736883/Work/PParMetrics/benchmarks/snu-npb/nauseous-omp/UA/src/diffuse.c(247),0,133,0.1203,1,0.8125,0.04167,0,0,0,44,22,22,44,22,22
/home/s1736883/Work/PParMetrics/benchmarks/snu-npb/nauseous-omp/UA/src/diffuse.c(248),0,123,0.878,1,0.1667,0.4194,0.03226,0.08264,0.08264,121,113,8,33,25,8
/home/s1736883/Work/PParMetrics/benchmarks/snu-npb/nauseous-omp/UA/src/diffuse.c(236),0,70,0,0,0,0,0,0,0,0,0,0,0,0,0
/home/s1736883/Work/PParMetrics/benchmarks/snu-npb/nauseous-omp/UA/src/diffuse.c(237),0,60,0.1667,1,0.7,0.08,0,0,0,20,10,10,20,10,10
/home/s1736883/Work/PParMetrics/benchmarks/snu-npb/nauseous-omp/UA/src/diffuse.c(238),0,50,0.82,1,0.1463,0.3964,0.02703,0.09091,0.09091,44,41,3,11,8,3
/home/s1736883/Work/PParMetrics/benchmarks/snu-npb/nauseous-omp/UA/src/diffuse.c(224),1,78,0,0,0,0,0,0,0,0,0,0,0,0,0
/home/s1736883/Work/PParMetrics/benchmarks/snu-npb/nauseous-omp/UA/src/diffuse.c(225),0,68,0.1471,1,0.7,0.06061,0,0,0,20,10,10,20,10,10
/home/s1736883/Work/PParMetrics/benchmarks/snu-npb/nauseous-omp/UA/src/diffuse.c(226),1,58,0,0,0,0,0,0,0,0,0,0,0,0,0
/home/s1736883/Work/PParMetrics/benchmarks/snu-npb/nauseous-omp/UA/src/diffuse.c(227),1,48,0.8125,1,0.1282,0.4,0.02857,0.1,0.1,40,38,2,8,6,2
/home/s1736883/Work/PParMetrics/benchmarks/snu-npb/nauseous-omp/UA/src/diffuse.c(213),1,78,0,0,0,0,0,0,0,0,0,0,0,0,0
/home/s1736883/Work/PParMetrics/benchmarks/snu-npb/nauseous-omp/UA/src/diffuse.c(214),0,68,0,0,0,0,0,0,0,0,0,0,0,0,0
/home/s1736883/Work/PParMetrics/benchmarks/snu-npb/nauseous-omp/UA/src/diffuse.c(215),1,58,0,0,0,0,0,0,0,0,0,0,0,0,0
/home/s1736883/Work/PParMetrics/benchmarks/snu-npb/nauseous-omp/UA/src/diffuse.c(216),1,48,0.8125,1,0.1282,0.4,0.02857,0.1,0.1,40,38,2,8,6,2
/home/s1736883/Work/PParMetrics/benchmarks/snu-npb/nauseous-omp/UA/src/mason.c(1486),1,235,0,0,0,0,0,0,0,0,0,0,0,0,0
/home/s1736883/Work/PParMetrics/benchmarks/snu-npb/nauseous-omp/UA/src/mason.c(1487),0,224,0.09821,2,0.7273,0.03644,0.01619,0.04255,0.02128,47,23,21,42,21,21
/home/s1736883/Work/PParMetrics/benchmarks/snu-npb/nauseous-omp/UA/src/mason.c(1498),0,190,0,0,0,0,0,0,0,0,0,0,0,0,0
/home/s1736883/Work/PParMetrics/benchmarks/snu-npb/nauseous-omp/UA/src/mason.c(1499),0,180,0.6944,3,0.176,0.3456,0.01416,0.07065,0.07065,184,146,38,80,42,38
/home/s1736883/Work/PParMetrics/benchmarks/snu-npb/nauseous-omp/UA/src/mason.c(1501),1,52,0.1731,1,0.6667,0.1,0,0,0,16,8,8,16,8,8
/home/s1736883/Work/PParMetrics/benchmarks/snu-npb/nauseous-omp/UA/src/mason.c(1502),1,42,0.8095,1,0.05882,0.4045,0.02247,0.06061,0.06061,33,32,1,3,2,1
/home/s1736883/Work/PParMetrics/benchmarks/snu-npb/nauseous-omp/UA/src/mason.c(1368),1,471,0.03822,2,0.6667,0.02867,0.008961,0.1395,0.1395,43,26,17,36,19,17
/home/s1736883/Work/PParMetrics/benchmarks/snu-npb/nauseous-omp/UA/src/mason.c(1371),0,440,0.08864,4,0.5897,0.0442,0.01105,0.05357,0.01786,112,59,47,94,47,47
/home/s1736883/Work/PParMetrics/benchmarks/snu-npb/nauseous-omp/UA/src/mason.c(1394),0,253,0.5494,2,0.1223,0.2636,0.02721,0.09392,0.09392,181,148,33,66,33,33
/home/s1736883/Work/PParMetrics/benchmarks/snu-npb/nauseous-omp/UA/src/mason.c(1469),0,53,0,0,0,0,0,0,0,0,0,0,0,0,0
/home/s1736883/Work/PParMetrics/benchmarks/snu-npb/nauseous-omp/UA/src/mason.c(1456),0,37,0.2162,1,0.625,0.1111,0,0,0,12,6,6,12,6,6
/home/s1736883/Work/PParMetrics/benchmarks/snu-npb/nauseous-omp/UA/src/mason.c(1470),1,43,0.814,1,0.1429,0.3978,0.02151,0.05556,0.05556,36,33,3,8,5,3
/home/s1736883/Work/PParMetrics/benchmarks/snu-npb/nauseous-omp/UA/src/mason.c(1457),1,27,0.7407,1,0.2,0.3621,0.01724,0.05,0.05,20,18,2,6,4,2
/home/s1736883/Work/PParMetrics/benchmarks/snu-npb/nauseous-omp/UA/src/mason.c(1354),1,17,0.4706,0,0,0.2703,0.05405,0,0,5,5,0,0,0,0
/home/s1736883/Work/PParMetrics/benchmarks/snu-npb/nauseous-omp/UA/src/mason.c(812),1,3177,0.515,2,0.1088,0.1113,0.01608,0.01747,0.01747,6985,4127,2858,5832,2974,2858
/home/s1736883/Work/PParMetrics/benchmarks/snu-npb/nauseous-omp/UA/src/mason.c(764),1,53,0.3774,2,0.5,0.2099,0.03704,0.1034,0.1034,29,19,10,22,12,10
/home/s1736883/Work/PParMetrics/benchmarks/snu-npb/nauseous-omp/UA/src/mason.c(768),0,29,0.5862,1,0.1176,0.3065,0.03226,0.1333,0.1333,15,14,1,2,1,1
/home/s1736883/Work/PParMetrics/benchmarks/snu-npb/nauseous-omp/UA/src/mason.c(752),1,17,0.4706,0,0,0.2703,0.05405,0,0,5,5,0,0,0,0
/home/s1736883/Work/PParMetrics/benchmarks/snu-npb/nauseous-omp/UA/src/mason.c(83),1,3019,0.4694,0,0,0.2254,0.03086,0,0,904,904,0,0,0,0
/home/s1736883/Work/PParMetrics/benchmarks/snu-npb/nauseous-omp/UA/src/mason.c(1879),0,663,0.07692,0,0,0.03521,0.008408,0,0,16,16,0,0,0,0
/home/s1736883/Work/PParMetrics/benchmarks/snu-npb/nauseous-omp/UA/src/mason.c(1837),0,161,0.2857,1,0.1087,0.1418,0.02736,0.2439,0.2439,41,37,4,8,4,4
/home/s1736883/Work/PParMetrics/benchmarks/snu-npb/nauseous-omp/UA/src/mason.c(1818),1,33,0.697,1,0.08696,0.3649,0.05405,0.1905,0.1905,21,20,1,2,1,1
/home/s1736883/Work/PParMetrics/benchmarks/snu-npb/nauseous-omp/UA/src/mason.c(1810),1,16,0.5,0,0,0.2941,0.05882,0,0,4,4,0,0,0,0
/home/s1736883/Work/PParMetrics/benchmarks/snu-npb/nauseous-omp/UA/src/mason.c(2182),1,19,0.5789,1,0.1818,0.3023,0.04651,0.2,0.2,10,9,1,3,2,1
/home/s1736883/Work/PParMetrics/benchmarks/snu-npb/nauseous-omp/UA/src/mason.c(2188),1,18,0.5556,1,0.2,0.2927,0.04878,0.2222,0.2222,9,8,1,3,2,1
/home/s1736883/Work/PParMetrics/benchmarks/snu-npb/nauseous-omp/UA/src/mason.c(2195),1,19,0.5789,1,0.1818,0.3023,0.04651,0.2,0.2,10,9,1,3,2,1
/home/s1736883/Work/PParMetrics/benchmarks/snu-npb/nauseous-omp/UA/src/mason.c(2201),1,18,0.5556,1,0.2,0.2927,0.04878,0.2222,0.2222,9,8,1,3,2,1
/home/s1736883/Work/PParMetrics/benchmarks/snu-npb/nauseous-omp/UA/src/mason.c(2208),1,19,0.5789,1,0.1818,0.3023,0.04651,0.2,0.2,10,9,1,3,2,1
/home/s1736883/Work/PParMetrics/benchmarks/snu-npb/nauseous-omp/UA/src/mason.c(2214),1,18,0.5556,1,0.2,0.2927,0.04878,0.2222,0.2222,9,8,1,3,2,1
/home/s1736883/Work/PParMetrics/benchmarks/snu-npb/nauseous-omp/UA/src/mason.c(2221),1,19,0.5789,1,0.1818,0.3023,0.04651,0.2,0.2,10,9,1,3,2,1
/home/s1736883/Work/PParMetrics/benchmarks/snu-npb/nauseous-omp/UA/src/mason.c(2227),1,18,0.5556,1,0.2,0.2927,0.04878,0.2222,0.2222,9,8,1,3,2,1
/home/s1736883/Work/PParMetrics/benchmarks/snu-npb/nauseous-omp/UA/src/mason.c(1693),1,29,0.7241,0,0,0.377,0.03279,0,0,18,18,0,0,0,0
/home/s1736883/Work/PParMetrics/benchmarks/snu-npb/nauseous-omp/UA/src/mason.c(1688),1,30,0.7333,0,0,0.381,0.03175,0,0,19,19,0,0,0,0
/home/s1736883/Work/PParMetrics/benchmarks/snu-npb/nauseous-omp/UA/src/mason.c(1677),1,29,0.7241,0,0,0.377,0.03279,0,0,18,18,0,0,0,0
/home/s1736883/Work/PParMetrics/benchmarks/snu-npb/nauseous-omp/UA/src/mason.c(1671),1,30,0.7333,0,0,0.381,0.03175,0,0,19,19,0,0,0,0
/home/s1736883/Work/PParMetrics/benchmarks/snu-npb/nauseous-omp/UA/src/mason.c(1660),1,29,0.7241,0,0,0.377,0.03279,0,0,18,18,0,0,0,0
/home/s1736883/Work/PParMetrics/benchmarks/snu-npb/nauseous-omp/UA/src/mason.c(1654),1,30,0.7333,0,0,0.381,0.03175,0,0,19,19,0,0,0,0
/home/s1736883/Work/PParMetrics/benchmarks/snu-npb/nauseous-omp/UA/src/mason.c(1639),1,29,0.7241,0,0,0.377,0.03279,0,0,18,18,0,0,0,0
/home/s1736883/Work/PParMetrics/benchmarks/snu-npb/nauseous-omp/UA/src/mason.c(1635),1,30,0.7333,0,0,0.381,0.03175,0,0,19,19,0,0,0,0
/home/s1736883/Work/PParMetrics/benchmarks/snu-npb/nauseous-omp/UA/src/move.c(103),1,100,0.73,0,0,0.4043,0.08696,0,0,61,61,0,0,0,0
/home/s1736883/Work/PParMetrics/benchmarks/snu-npb/nauseous-omp/UA/src/move.c(54),1,351,0.1425,1,0.3,0.127,0.01622,0.09524,0.09524,63,49,14,28,14,14
/home/s1736883/Work/PParMetrics/benchmarks/snu-npb/nauseous-omp/UA/src/move.c(61),1,287,0.4216,1,0.04959,0.3093,0.08349,0.03333,0.03333,120,111,9,18,9,9
/home/s1736883/Work/PParMetrics/benchmarks/snu-npb/nauseous-omp/UA/src/move.c(82),1,65,0,0,0,0,0,0,0,0,0,0,0,0,0
/home/s1736883/Work/PParMetrics/benchmarks/snu-npb/nauseous-omp/UA/src/move.c(83),1,55,0.8545,1,0.04255,0.4375,0.01786,0.04651,0.04651,43,42,1,2,1,1
/home/s1736883/Work/PParMetrics/benchmarks/snu-npb/nauseous-omp/UA/src/precond.c(90),1,18,0.5,1,0.3333,0.2683,0.04878,0.25,0.25,8,7,1,4,3,1
/home/s1736883/Work/PParMetrics/benchmarks/snu-npb/nauseous-omp/UA/src/precond.c(62),1,196,0.148,2,0.5862,0.07207,0.009009,0.01786,0.01786,56,32,24,48,24,24
/home/s1736883/Work/PParMetrics/benchmarks/snu-npb/nauseous-omp/UA/src/precond.c(65),1,173,0,0,0,0,0,0,0,0,0,0,0,0,0
/home/s1736883/Work/PParMetrics/benchmarks/snu-npb/nauseous-omp/UA/src/precond.c(66),1,163,0.09202,1,0.8,0.03509,0,0,0,40,20,20,40,20,20
/home/s1736883/Work/PParMetrics/benchmarks/snu-npb/nauseous-omp/UA/src/precond.c(67),1,153,0.3595,2,0.2909,0.2956,0.01887,0.03797,0.03797,79,59,20,43,23,20
/home/s1736883/Work/PParMetrics/benchmarks/snu-npb/nauseous-omp/UA/src/precond.c(68),1,100,0.88,1,0.05682,0.4413,0.02817,0.05747,0.05747,87,86,1,6,5,1
/home/s1736883/Work/PParMetrics/benchmarks/snu-npb/nauseous-omp/UA/src/precond.c(53),1,40,0.25,1,0.7,0.09091,0,0,0,20,10,10,20,10,10
/home/s1736883/Work/PParMetrics/benchmarks/snu-npb/nauseous-omp/UA/src/precond.c(54),1,30,0.7,0,0,0.3692,0.04615,0,0,18,18,0,0,0,0
/home/s1736883/Work/PParMetrics/benchmarks/snu-npb/nauseous-omp/UA/src/precond.c(134),1,1919,0.1626,3,0.2724,0.01727,0.005177,0.01906,0.01906,1364,792,572,1161,589,572
/home/s1736883/Work/PParMetrics/benchmarks/snu-npb/nauseous-omp/UA/src/precond.c(142),0,186,0,0,0,0,0,0,0,0,0,0,0,0,0
/home/s1736883/Work/PParMetrics/benchmarks/snu-npb/nauseous-omp/UA/src/precond.c(166),0,161,0.3478,2,0.375,0.2233,0.02427,0.0404,0.0404,99,67,32,67,35,32
/home/s1736883/Work/PParMetrics/benchmarks/snu-npb/nauseous-omp/UA/src/precond.c(196),0,230,0.7304,2,0.06548,0.4127,0.03302,0.0241,0.0241,166,152,14,29,15,14
/home/s1736883/Work/PParMetrics/benchmarks/snu-npb/nauseous-omp/UA/src/precond.c(254),1,83,0.8554,3,0.08451,0.4254,0.03315,0.08333,0.08333,72,69,3,9,6,3
/home/s1736883/Work/PParMetrics/benchmarks/snu-npb/nauseous-omp/UA/src/precond.c(263),1,119,0.6807,4,0.2593,0.315,0.02362,0.08696,0.08696,138,102,36,75,39,36
/home/s1736883/Work/PParMetrics/benchmarks/snu-npb/nauseous-omp/UA/src/precond.c(285),1,119,0.6807,4,0.2593,0.315,0.02362,0.08696,0.08696,138,102,36,75,39,36
/home/s1736883/Work/PParMetrics/benchmarks/snu-npb/nauseous-omp/UA/src/precond.c(300),1,83,0.8554,3,0.08451,0.4254,0.03315,0.08333,0.08333,72,69,3,9,6,3
/home/s1736883/Work/PParMetrics/benchmarks/snu-npb/nauseous-omp/UA/src/precond.c(318),1,123,0.6829,4,0.25,0.3192,0.02308,0.08511,0.08511,141,105,36,75,39,36
/home/s1736883/Work/PParMetrics/benchmarks/snu-npb/nauseous-omp/UA/src/precond.c(332),1,86,0.8605,3,0.08108,0.4278,0.03209,0.08,0.08,75,72,3,9,6,3
/home/s1736883/Work/PParMetrics/benchmarks/snu-npb/nauseous-omp/UA/src/precond.c(360),1,18,0.5556,0,0,0.3077,0.05128,0,0,7,7,0,0,0,0
/home/s1736883/Work/PParMetrics/benchmarks/snu-npb/nauseous-omp/UA/src/precond.c(368),1,28,0.6429,0,0,0.3548,0.06452,0,0,14,14,0,0,0,0
/home/s1736883/Work/PParMetrics/benchmarks/snu-npb/nauseous-omp/UA/src/precond.c(377),1,38,0.6842,0,0,0.3765,0.07059,0,0,21,21,0,0,0,0
/home/s1736883/Work/PParMetrics/benchmarks/snu-npb/nauseous-omp/UA/src/precond.c(387),1,33,0,0,0,0,0,0,0,0,0,0,0,0,0
/home/s1736883/Work/PParMetrics/benchmarks/snu-npb/nauseous-omp/UA/src/precond.c(402),1,18,0.5556,0,0,0.3077,0.05128,0,0,7,7,0,0,0,0
/home/s1736883/Work/PParMetrics/benchmarks/snu-npb/nauseous-omp/UA/src/precond.c(410),1,48,0,0,0,0,0,0,0,0,0,0,0,0,0
/home/s1736883/Work/PParMetrics/benchmarks/snu-npb/nauseous-omp/UA/src/precond.c(420),0,63,0.2063,1,0.7692,0.06452,0,0,0,32,16,16,32,16,16
/home/s1736883/Work/PParMetrics/benchmarks/snu-npb/nauseous-omp/UA/src/precond.c(143),0,175,0.8686,0,0,0.4531,0.04558,0,0,139,139,0,0,0,0
/home/s1736883/Work/PParMetrics/benchmarks/snu-npb/nauseous-omp/UA/src/precond.c(167),0,109,0.8073,1,0.07955,0.411,0.03814,0.05814,0.05814,86,80,6,16,10,6
/home/s1736883/Work/PParMetrics/benchmarks/snu-npb/nauseous-omp/UA/src/precond.c(208),1,46,0.4565,2,0.4286,0.2319,0.02899,0.06897,0.06897,29,19,10,20,10,10
/home/s1736883/Work/PParMetrics/benchmarks/snu-npb/nauseous-omp/UA/src/precond.c(264),1,33,0.7576,1,0.08,0.3803,0.02817,0.08333,0.08333,24,23,1,3,2,1
/home/s1736883/Work/PParMetrics/benchmarks/snu-npb/nauseous-omp/UA/src/precond.c(293),1,33,0.7576,1,0.08,0.3803,0.02817,0.08333,0.08333,24,23,1,3,2,1
/home/s1736883/Work/PParMetrics/benchmarks/snu-npb/nauseous-omp/UA/src/precond.c(319),1,34,0.7647,1,0.07692,0.3836,0.0274,0.08,0.08,25,24,1,3,2,1
/home/s1736883/Work/PParMetrics/benchmarks/snu-npb/nauseous-omp/UA/src/precond.c(388),1,23,0.6522,0,0,0.3469,0.04082,0,0,12,12,0,0,0,0
/home/s1736883/Work/PParMetrics/benchmarks/snu-npb/nauseous-omp/UA/src/precond.c(398),1,23,0.6522,0,0,0.3469,0.04082,0,0,12,12,0,0,0,0
/home/s1736883/Work/PParMetrics/benchmarks/snu-npb/nauseous-omp/UA/src/precond.c(411),1,38,0.7368,0,0,0.3902,0.04878,0,0,24,24,0,0,0,0
/home/s1736883/Work/PParMetrics/benchmarks/snu-npb/nauseous-omp/UA/src/precond.c(421),0,53,0.7736,0,0,0.4087,0.05217,0,0,36,36,0,0,0,0
/home/s1736883/Work/PParMetrics/benchmarks/snu-npb/nauseous-omp/UA/src/precond.c(212),1,24,0.6667,1,0.125,0.3396,0.03774,0.1333,0.1333,15,14,1,3,2,1
/home/s1736883/Work/PParMetrics/benchmarks/snu-npb/nauseous-omp/UA/src/precond.c(122),1,68,0.2794,2,0.5263,0.1529,0.02353,0.06667,0.06667,30,18,12,24,12,12
/home/s1736883/Work/PParMetrics/benchmarks/snu-npb/nauseous-omp/UA/src/precond.c(125),1,49,0.1837,1,0.6667,0.09524,0,0,0,16,8,8,16,8,8
/home/s1736883/Work/PParMetrics/benchmarks/snu-npb/nauseous-omp/UA/src/precond.c(126),0,39,0.7949,1,0.09677,0.3976,0.0241,0.1,0.1,30,29,1,4,3,1
/home/s1736883/Work/PParMetrics/benchmarks/snu-npb/nauseous-omp/UA/src/precond.c(117),1,32,0.75,1,0.125,0.3768,0.02899,0.1304,0.1304,23,22,1,4,3,1
/home/s1736883/Work/PParMetrics/benchmarks/snu-npb/nauseous-omp/UA/src/precond.c(460),1,748,0.04947,1,0.9189,0.003268,0,0,0,128,64,64,128,64,64
/home/s1736883/Work/PParMetrics/benchmarks/snu-npb/nauseous-omp/UA/src/precond.c(461),0,737,0.209,2,0.5065,0.08375,0.01207,0.0375,0.02321,560,319,213,478,245,213
/home/s1736883/Work/PParMetrics/benchmarks/snu-npb/nauseous-omp/UA/src/precond.c(496),0,267,0.1273,0,0,0.06588,0.008446,0,0,15,15,0,0,0,0
/home/s1736883/Work/PParMetrics/benchmarks/snu-npb/nauseous-omp/UA/src/precond.c(541),0,91,0.0989,1,0.6667,0.05,0,0,0,16,8,8,16,8,8
/home/s1736883/Work/PParMetrics/benchmarks/snu-npb/nauseous-omp/UA/src/precond.c(556),0,100,0.88,1,0.04545,0.4352,0.02778,0.04444,0.04444,90,86,4,8,4,4
/home/s1736883/Work/PParMetrics/benchmarks/snu-npb/nauseous-omp/UA/src/precond.c(569),0,100,0.88,1,0.04545,0.4352,0.02778,0.04444,0.04444,90,86,4,8,4,4
/home/s1736883/Work/PParMetrics/benchmarks/snu-npb/nauseous-omp/UA/src/precond.c(542),0,81,0.1235,1,0.7,0.0625,0,0,0,20,10,10,20,10,10
/home/s1736883/Work/PParMetrics/benchmarks/snu-npb/nauseous-omp/UA/src/precond.c(543),0,71,0,0,0,0,0,0,0,0,0,0,0,0,0
/home/s1736883/Work/PParMetrics/benchmarks/snu-npb/nauseous-omp/UA/src/precond.c(544),0,61,0.8525,1,0.03846,0.4297,0.02344,0.04,0.04,50,49,1,2,1,1
/home/s1736883/Work/PParMetrics/benchmarks/snu-npb/nauseous-omp/UA/src/precond.c(449),1,39,0.2051,1,0.625,0.08696,0,0,0,12,6,6,12,6,6
/home/s1736883/Work/PParMetrics/benchmarks/snu-npb/nauseous-omp/UA/src/precond.c(450),0,28,0.2857,1,0.625,0.125,0,0,0,12,6,6,12,6,6
/home/s1736883/Work/PParMetrics/benchmarks/snu-npb/nauseous-omp/UA/src/precond.c(451),0,18,0.6111,0,0,0.3243,0.02703,0,0,8,8,0,0,0,0
/home/s1736883/Work/PParMetrics/benchmarks/snu-npb/nauseous-omp/UA/src/precond.c(444),1,13,0.3846,0,0,0.2222,0.03704,0,0,2,2,0,0,0,0
/home/s1736883/Work/PParMetrics/benchmarks/snu-npb/nauseous-omp/UA/src/precond.c(763),0,145,0.06207,1,0.8889,0.02586,0.008621,0.04,0.04,25,13,12,24,12,12
/home/s1736883/Work/PParMetrics/benchmarks/snu-npb/nauseous-omp/UA/src/precond.c(764),0,132,0.1061,1,0.6429,0.06522,0,0.03333,0.03333,30,16,14,28,14,14
/home/s1736883/Work/PParMetrics/benchmarks/snu-npb/nauseous-omp/UA/src/precond.c(765),0,119,0.1176,1,0.6429,0.09091,0,0.03333,0.03333,30,16,14,28,14,14
/home/s1736883/Work/PParMetrics/benchmarks/snu-npb/nauseous-omp/UA/src/precond.c(766),0,106,0.8868,2,0.04255,0.4439,0.02242,0.04301,0.04301,93,91,2,4,2,2
/home/s1736883/Work/PParMetrics/benchmarks/snu-npb/nauseous-omp/UA/src/setup.c(63),1,12,0.4167,0,0,0.24,0.04,0,0,2,2,0,0,0,0
/home/s1736883/Work/PParMetrics/benchmarks/snu-npb/nauseous-omp/UA/src/setup.c(58),1,17,0.5294,0,0,0.3056,0.05556,0,0,5,5,0,0,0,0
/home/s1736883/Work/PParMetrics/benchmarks/snu-npb/nauseous-omp/UA/src/setup.c(51),1,27,0.6296,0,0,0.3621,0.06897,0,0,11,11,0,0,0,0
/home/s1736883/Work/PParMetrics/benchmarks/snu-npb/nauseous-omp/UA/src/setup.c(46),1,17,0.5294,0,0,0.3056,0.05556,0,0,5,5,0,0,0,0
/home/s1736883/Work/PParMetrics/benchmarks/snu-npb/nauseous-omp/UA/src/setup.c(210),1,17,0.5294,0,0,0.2973,0.05405,0,0,6,6,0,0,0,0
/home/s1736883/Work/PParMetrics/benchmarks/snu-npb/nauseous-omp/UA/src/setup.c(198),1,22,0.6364,0,0,0.3404,0.04255,0,0,11,11,0,0,0,0
/home/s1736883/Work/PParMetrics/benchmarks/snu-npb/nauseous-omp/UA/src/setup.c(192),1,24,0.6667,0,0,0.3529,0.03922,0,0,13,13,0,0,0,0
/home/s1736883/Work/PParMetrics/benchmarks/snu-npb/nauseous-omp/UA/src/setup.c(186),1,22,0.6364,0,0,0.3404,0.04255,0,0,11,11,0,0,0,0
/home/s1736883/Work/PParMetrics/benchmarks/snu-npb/nauseous-omp/UA/src/setup.c(153),1,34,0,0,0,0,0,0,0,0,0,0,0,0,0
/home/s1736883/Work/PParMetrics/benchmarks/snu-npb/nauseous-omp/UA/src/setup.c(154),1,24,0.6667,1,0.125,0.3396,0.03774,0.1333,0.1333,15,14,1,3,2,1
/home/s1736883/Work/PParMetrics/benchmarks/snu-npb/nauseous-omp/UA/src/setup.c(131),1,22,0.6364,0,0,0.3404,0.04255,0,0,11,11,0,0,0,0
/home/s1736883/Work/PParMetrics/benchmarks/snu-npb/nauseous-omp/UA/src/setup.c(126),1,25,0.68,1,0.1765,0.3455,0.03636,0.125,0.125,16,15,1,4,3,1
/home/s1736883/Work/PParMetrics/benchmarks/snu-npb/nauseous-omp/UA/src/setup.c(101),1,52,0,0,0,0,0,0,0,0,0,0,0,0,0
/home/s1736883/Work/PParMetrics/benchmarks/snu-npb/nauseous-omp/UA/src/setup.c(102),1,42,0.2143,1,0.6667,0.1053,0,0,0,16,8,8,16,8,8
/home/s1736883/Work/PParMetrics/benchmarks/snu-npb/nauseous-omp/UA/src/setup.c(103),1,32,0.75,0,0,0.3881,0.02985,0,0,21,21,0,0,0,0
/home/s1736883/Work/PParMetrics/benchmarks/snu-npb/nauseous-omp/UA/src/setup.c(265),1,147,0.04762,1,1,0.01242,0.006211,0,0,12,6,6,12,6,6
/home/s1736883/Work/PParMetrics/benchmarks/snu-npb/nauseous-omp/UA/src/setup.c(267),1,134,0,0,0,0,0,0,0,0,0,0,0,0,0
/home/s1736883/Work/PParMetrics/benchmarks/snu-npb/nauseous-omp/UA/src/setup.c(268),1,124,0.8548,0,0,0.4436,0.04511,0,0,98,98,0,0,0,0
/home/s1736883/Work/PParMetrics/benchmarks/snu-npb/nauseous-omp/UA/src/setup.c(243),1,242,0.09091,4,0.6818,0.06081,0.003378,0.2857,0.2857,35,24,11,22,11,11
/home/s1736883/Work/PParMetrics/benchmarks/snu-npb/nauseous-omp/UA/src/setup.c(248),1,213,0,0,0,0,0,0,0,0,0,0,0,0,0
/home/s1736883/Work/PParMetrics/benchmarks/snu-npb/nauseous-omp/UA/src/setup.c(249),1,203,0,0,0,0,0,0,0,0,0,0,0,0,0
/home/s1736883/Work/PParMetrics/benchmarks/snu-npb/nauseous-omp/UA/src/setup.c(250),1,193,0.8964,1,0.02312,0.4539,0.03398,0.04734,0.04734,169,166,3,6,3,3
/home/s1736883/Work/PParMetrics/benchmarks/snu-npb/nauseous-omp/UA/src/setup.c(237),1,18,0.5556,0,0,0.3077,0.05128,0,0,7,7,0,0,0,0
/home/s1736883/Work/PParMetrics/benchmarks/snu-npb/nauseous-omp/UA/src/setup.c(290),1,63,0.1587,1,0.7,0.06061,0,0,0,20,10,10,20,10,10
/home/s1736883/Work/PParMetrics/benchmarks/snu-npb/nauseous-omp/UA/src/setup.c(291),1,53,0.1887,1,0.7,0.08696,0,0,0,20,10,10,20,10,10
/home/s1736883/Work/PParMetrics/benchmarks/snu-npb/nauseous-omp/UA/src/setup.c(292),1,43,0.7907,1,0.08824,0.3978,0.03226,0.09091,0.09091,33,32,1,4,3,1
/home/s1736883/Work/PParMetrics/benchmarks/snu-npb/nauseous-omp/UA/src/setup.c(338),1,484,0,0,0,0,0,0,0,0,0,0,0,0,0
/home/s1736883/Work/PParMetrics/benchmarks/snu-npb/nauseous-omp/UA/src/setup.c(339),0,473,0.3679,2,0.431,0.06771,0.003595,0.002863,0.0007158,1397,731,658,1316,658,658
/home/s1736883/Work/PParMetrics/benchmarks/snu-npb/nauseous-omp/UA/src/setup.c(342),0,36,0.2222,1,0.625,0.125,0,0,0,12,6,6,12,6,6
/home/s1736883/Work/PParMetrics/benchmarks/snu-npb/nauseous-omp/UA/src/setup.c(349),0,26,0.7308,0,0,0.3774,0.01887,0,0,16,16,0,0,0,0
/home/s1736883/Work/PParMetrics/benchmarks/snu-npb/nauseous-omp/UA/src/setup.c(357),0,26,0.7308,0,0,0.3774,0.01887,0,0,16,16,0,0,0,0
/home/s1736883/Work/PParMetrics/benchmarks/snu-npb/nauseous-omp/UA/src/setup.c(369),0,26,0.7308,0,0,0.3774,0.01887,0,0,16,16,0,0,0,0
/home/s1736883/Work/PParMetrics/benchmarks/snu-npb/nauseous-omp/UA/src/setup.c(372),0,26,0.7308,0,0,0.3774,0.01887,0,0,16,16,0,0,0,0
/home/s1736883/Work/PParMetrics/benchmarks/snu-npb/nauseous-omp/UA/src/setup.c(364),0,26,0.7308,0,0,0.3774,0.01887,0,0,16,16,0,0,0,0
/home/s1736883/Work/PParMetrics/benchmarks/snu-npb/nauseous-omp/UA/src/setup.c(384),0,26,0.7308,0,0,0.3774,0.01887,0,0,16,16,0,0,0,0
/home/s1736883/Work/PParMetrics/benchmarks/snu-npb/nauseous-omp/UA/src/setup.c(387),0,26,0.7308,0,0,0.3774,0.01887,0,0,16,16,0,0,0,0
/home/s1736883/Work/PParMetrics/benchmarks/snu-npb/nauseous-omp/UA/src/setup.c(380),0,26,0.7308,0,0,0.3774,0.01887,0,0,16,16,0,0,0,0
/home/s1736883/Work/PParMetrics/benchmarks/snu-npb/nauseous-omp/UA/src/setup.c(393),0,26,0.7308,0,0,0.3774,0.01887,0,0,16,16,0,0,0,0
/home/s1736883/Work/PParMetrics/benchmarks/snu-npb/nauseous-omp/UA/src/setup.c(398),0,26,0.7308,0,0,0.3774,0.01887,0,0,16,16,0,0,0,0
/home/s1736883/Work/PParMetrics/benchmarks/snu-npb/nauseous-omp/UA/src/setup.c(343),0,26,0.7308,0,0,0.3774,0.01887,0,0,16,16,0,0,0,0
/home/s1736883/Work/PParMetrics/benchmarks/snu-npb/nauseous-omp/UA/src/setup.c(333),1,13,0.3846,0,0,0.2222,0.03704,0,0,2,2,0,0,0,0
/home/s1736883/Work/PParMetrics/benchmarks/snu-npb/nauseous-omp/UA/src/setup.c(324),1,32,0.4375,1,0.3571,0.2245,0.02041,0,0,17,11,6,12,6,6
/home/s1736883/Work/PParMetrics/benchmarks/snu-npb/nauseous-omp/UA/src/setup.c(326),0,14,0.5,0,0,0.2759,0.03448,0,0,4,4,0,0,0,0
/home/s1736883/Work/PParMetrics/benchmarks/snu-npb/nauseous-omp/UA/src/setup.c(318),1,31,0.6774,0,0,0.3582,0.04478,0,0,18,18,0,0,0,0
/home/s1736883/Work/PParMetrics/benchmarks/snu-npb/nauseous-omp/UA/src/transfer.c(46),1,12,0.4167,0,0,0.24,0.04,0,0,2,2,0,0,0,0
/home/s1736883/Work/PParMetrics/benchmarks/snu-npb/nauseous-omp/UA/src/transfer.c(66),1,1251,0,0,0,0,0,0,0,0,0,0,0,0,0
/home/s1736883/Work/PParMetrics/benchmarks/snu-npb/nauseous-omp/UA/src/transfer.c(67),0,1240,0.0871,1,0.7963,0.001063,0.0004832,0.002444,0,3273,1625,1624,3248,1624,1624
/home/s1736883/Work/PParMetrics/benchmarks/snu-npb/nauseous-omp/UA/src/transfer.c(172),0,58,0,0,0,0,0,0,0,0,0,0,0,0,0
/home/s1736883/Work/PParMetrics/benchmarks/snu-npb/nauseous-omp/UA/src/transfer.c(196),0,44,0.8182,1,0.3611,0.3762,0.0198,0.06977,0.06977,43,37,6,22,16,6
/home/s1736883/Work/PParMetrics/benchmarks/snu-npb/nauseous-omp/UA/src/transfer.c(184),0,85,0.3412,3,0.5862,0.1649,0.01031,0.02273,0.02273,44,27,17,34,17,17
/home/s1736883/Work/PParMetrics/benchmarks/snu-npb/nauseous-omp/UA/src/transfer.c(217),0,44,0.8182,1,0.3611,0.3762,0.0198,0.06977,0.06977,43,37,6,22,16,6
/home/s1736883/Work/PParMetrics/benchmarks/snu-npb/nauseous-omp/UA/src/transfer.c(205),0,85,0.3412,3,0.5862,0.1649,0.01031,0.02273,0.02273,44,27,17,34,17,17
/home/s1736883/Work/PParMetrics/benchmarks/snu-npb/nauseous-omp/UA/src/transfer.c(238),0,44,0.8182,1,0.3611,0.3762,0.0198,0.06977,0.06977,43,37,6,22,16,6
/home/s1736883/Work/PParMetrics/benchmarks/snu-npb/nauseous-omp/UA/src/transfer.c(226),0,85,0.1647,1,0.5714,0.1134,0.04124,0.05,0.05,20,13,7,14,7,7
/home/s1736883/Work/PParMetrics/benchmarks/snu-npb/nauseous-omp/UA/src/transfer.c(258),0,44,0.8182,1,0.3611,0.3762,0.0198,0.06977,0.06977,43,37,6,22,16,6
/home/s1736883/Work/PParMetrics/benchmarks/snu-npb/nauseous-omp/UA/src/transfer.c(247),0,85,0.3412,3,0.5862,0.1649,0.01031,0.02273,0.02273,44,27,17,34,17,17
/home/s1736883/Work/PParMetrics/benchmarks/snu-npb/nauseous-omp/UA/src/transfer.c(100),1,162,0,0,0,0,0,0,0,0,0,0,0,0,0
/home/s1736883/Work/PParMetrics/benchmarks/snu-npb/nauseous-omp/UA/src/transfer.c(125),0,265,0,0,0,0,0,0,0,0,0,0,0,0,0
/home/s1736883/Work/PParMetrics/benchmarks/snu-npb/nauseous-omp/UA/src/transfer.c(173),0,48,0.8333,1,0.325,0.3853,0.01835,0.06383,0.06383,47,41,6,22,16,6
/home/s1736883/Work/PParMetrics/benchmarks/snu-npb/nauseous-omp/UA/src/transfer.c(186),0,63,0,0,0,0,0,0,0,0,0,0,0,0,0
/home/s1736883/Work/PParMetrics/benchmarks/snu-npb/nauseous-omp/UA/src/transfer.c(207),0,63,0,0,0,0,0,0,0,0,0,0,0,0,0
/home/s1736883/Work/PParMetrics/benchmarks/snu-npb/nauseous-omp/UA/src/transfer.c(228),0,63,0,0,0,0,0,0,0,0,0,0,0,0,0
/home/s1736883/Work/PParMetrics/benchmarks/snu-npb/nauseous-omp/UA/src/transfer.c(249),0,63,0,0,0,0,0,0,0,0,0,0,0,0,0
/home/s1736883/Work/PParMetrics/benchmarks/snu-npb/nauseous-omp/UA/src/transfer.c(101),0,151,0.08609,1,0.7692,0.02778,0,0,0,32,16,16,32,16,16
/home/s1736883/Work/PParMetrics/benchmarks/snu-npb/nauseous-omp/UA/src/transfer.c(132),0,66,0.4545,3,0.5333,0.2222,0.01235,0.02273,0.02273,44,28,16,32,16,16
/home/s1736883/Work/PParMetrics/benchmarks/snu-npb/nauseous-omp/UA/src/transfer.c(141),0,116,0.5,1,0.7069,0.2036,0.00905,0.03676,0.03676,136,86,50,122,72,50
/home/s1736883/Work/PParMetrics/benchmarks/snu-npb/nauseous-omp/UA/src/transfer.c(160),0,66,0.4545,3,0.5333,0.2222,0.01235,0.02273,0.02273,44,28,16,32,16,16
/home/s1736883/Work/PParMetrics/benchmarks/snu-npb/nauseous-omp/UA/src/transfer.c(187),0,53,0.8491,1,0.3556,0.3852,0.01639,0.09091,0.09091,55,48,7,28,21,7
/home/s1736883/Work/PParMetrics/benchmarks/snu-npb/nauseous-omp/UA/src/transfer.c(208),0,53,0.8491,1,0.3556,0.3852,0.01639,0.09091,0.09091,55,48,7,28,21,7
/home/s1736883/Work/PParMetrics/benchmarks/snu-npb/nauseous-omp/UA/src/transfer.c(229),0,53,0.8491,1,0.3556,0.3852,0.01639,0.09091,0.09091,55,48,7,28,21,7
/home/s1736883/Work/PParMetrics/benchmarks/snu-npb/nauseous-omp/UA/src/transfer.c(250),0,53,0.8491,1,0.3556,0.3852,0.01639,0.09091,0.09091,55,48,7,28,21,7
/home/s1736883/Work/PParMetrics/benchmarks/snu-npb/nauseous-omp/UA/src/transfer.c(102),1,140,0.2857,3,0.5,0.2147,0.06806,0.05556,0.05556,90,56,34,69,35,34
/home/s1736883/Work/PParMetrics/benchmarks/snu-npb/nauseous-omp/UA/src/transfer.c(134),0,42,0.8095,1,0.3235,0.3711,0.02062,0.09756,0.09756,41,36,5,20,15,5
/home/s1736883/Work/PParMetrics/benchmarks/snu-npb/nauseous-omp/UA/src/transfer.c(150),0,65,0.4615,3,0.5333,0.2222,0.01235,0.02273,0.02273,44,28,16,32,16,16
/home/s1736883/Work/PParMetrics/benchmarks/snu-npb/nauseous-omp/UA/src/transfer.c(162),0,42,0.8095,1,0.3235,0.3711,0.02062,0.09756,0.09756,41,36,5,20,15,5
/home/s1736883/Work/PParMetrics/benchmarks/snu-npb/nauseous-omp/UA/src/transfer.c(111),1,90,0.2444,1,0.2727,0.24,0.01333,0,0,28,20,8,16,8,8
/home/s1736883/Work/PParMetrics/benchmarks/snu-npb/nauseous-omp/UA/src/transfer.c(152),0,41,0.8049,1,0.303,0.3684,0.02105,0.1,0.1,40,35,5,19,14,5
/home/s1736883/Work/PParMetrics/benchmarks/snu-npb/nauseous-omp/UA/src/transfer.c(113),0,66,0.8788,2,0.1207,0.4286,0.01429,0.1,0.1,60,57,3,10,7,3
/home/s1736883/Work/PParMetrics/benchmarks/snu-npb/nauseous-omp/UA/src/transfer.c(293),1,1555,0,0,0,0,0,0,0,0,0,0,0,0,0
/home/s1736883/Work/PParMetrics/benchmarks/snu-npb/nauseous-omp/UA/src/transfer.c(294),0,1544,0.08938,2,0.7246,0.002625,0.000975,0.002818,0,2839,1412,1403,2806,1403,1403
/home/s1736883/Work/PParMetrics/benchmarks/snu-npb/nauseous-omp/UA/src/transfer.c(436),0,72,0,0,0,0,0,0,0,0,0,0,0,0,0
/home/s1736883/Work/PParMetrics/benchmarks/snu-npb/nauseous-omp/UA/src/transfer.c(468),0,59,0.8644,1,0.4314,0.3813,0.01439,0.07576,0.07576,66,55,11,39,28,11
/home/s1736883/Work/PParMetrics/benchmarks/snu-npb/nauseous-omp/UA/src/transfer.c(451),0,98,0,0,0,0,0,0,0,0,0,0,0,0,0
/home/s1736883/Work/PParMetrics/benchmarks/snu-npb/nauseous-omp/UA/src/transfer.c(497),0,59,0.8644,1,0.4314,0.3813,0.01439,0.07576,0.07576,66,55,11,39,28,11
/home/s1736883/Work/PParMetrics/benchmarks/snu-npb/nauseous-omp/UA/src/transfer.c(480),0,98,0,0,0,0,0,0,0,0,0,0,0,0,0
/home/s1736883/Work/PParMetrics/benchmarks/snu-npb/nauseous-omp/UA/src/transfer.c(526),0,59,0.8644,1,0.4314,0.3813,0.01439,0.07576,0.07576,66,55,11,39,28,11
/home/s1736883/Work/PParMetrics/benchmarks/snu-npb/nauseous-omp/UA/src/transfer.c(509),0,98,0,0,0,0,0,0,0,0,0,0,0,0,0
/home/s1736883/Work/PParMetrics/benchmarks/snu-npb/nauseous-omp/UA/src/transfer.c(555),0,59,0.8644,1,0.4314,0.3813,0.01439,0.07576,0.07576,66,55,11,39,28,11
/home/s1736883/Work/PParMetrics/benchmarks/snu-npb/nauseous-omp/UA/src/transfer.c(538),0,98,0,0,0,0,0,0,0,0,0,0,0,0,0
/home/s1736883/Work/PParMetrics/benchmarks/snu-npb/nauseous-omp/UA/src/transfer.c(339),1,196,0,0,0,0,0,0,0,0,0,0,0,0,0
/home/s1736883/Work/PParMetrics/benchmarks/snu-npb/nauseous-omp/UA/src/transfer.c(372),0,349,0.06017,2,0.8571,0.007947,0.001325,0,0,56,28,28,56,28,28
/home/s1736883/Work/PParMetrics/benchmarks/snu-npb/nauseous-omp/UA/src/transfer.c(437),0,62,0.871,1,0.3889,0.3862,0.01379,0.07246,0.07246,69,58,11,38,27,11
/home/s1736883/Work/PParMetrics/benchmarks/snu-npb/nauseous-omp/UA/src/transfer.c(452),0,88,0.4091,1,0.6389,0.2549,0.05229,0.01515,0.01515,66,45,21,55,34,21
/home/s1736883/Work/PParMetrics/benchmarks/snu-npb/nauseous-omp/UA/src/transfer.c(481),0,88,0.4318,1,0.6053,0.2418,0.02614,0.04286,0.04286,70,49,21,55,34,21
/home/s1736883/Work/PParMetrics/benchmarks/snu-npb/nauseous-omp/UA/src/transfer.c(510),0,88,0.4091,1,0.6389,0.2549,0.05229,0.01515,0.01515,66,45,21,55,34,21
/home/s1736883/Work/PParMetrics/benchmarks/snu-npb/nauseous-omp/UA/src/transfer.c(539),0,88,0.4318,1,0.6053,0.2418,0.02614,0.04286,0.04286,70,49,21,55,34,21
/home/s1736883/Work/PParMetrics/benchmarks/snu-npb/nauseous-omp/UA/src/transfer.c(341),1,183,0.3169,3,0.5,0.1579,0.04334,0.03846,0.03846,156,93,63,127,64,63
/home/s1736883/Work/PParMetrics/benchmarks/snu-npb/nauseous-omp/UA/src/transfer.c(374),0,336,0.3899,2,0.7405,0.08221,0.003681,0.01292,0.01292,619,336,283,589,306,283
/home/s1736883/Work/PParMetrics/benchmarks/snu-npb/nauseous-omp/UA/src/transfer.c(454),1,40,0.8,2,0.2188,0.3864,0.02273,0.1176,0.1176,34,31,3,10,7,3
/home/s1736883/Work/PParMetrics/benchmarks/snu-npb/nauseous-omp/UA/src/transfer.c(483),1,40,0.8,2,0.2188,0.3864,0.02273,0.1176,0.1176,34,31,3,10,7,3
/home/s1736883/Work/PParMetrics/benchmarks/snu-npb/nauseous-omp/UA/src/transfer.c(512),1,40,0.8,2,0.2188,0.3864,0.02273,0.1176,0.1176,34,31,3,10,7,3
/home/s1736883/Work/PParMetrics/benchmarks/snu-npb/nauseous-omp/UA/src/transfer.c(541),1,40,0.8,2,0.2188,0.3864,0.02273,0.1176,0.1176,34,31,3,10,7,3
/home/s1736883/Work/PParMetrics/benchmarks/snu-npb/nauseous-omp/UA/src/transfer.c(351),1,42,0.8095,2,0.2059,0.3913,0.02174,0.1111,0.1111,36,33,3,10,7,3
/home/s1736883/Work/PParMetrics/benchmarks/snu-npb/nauseous-omp/UA/src/transfer.c(360),0,77,0.4286,2,0.4242,0.2547,0.01887,0.03922,0.03922,51,35,16,35,19,16
/home/s1736883/Work/PParMetrics/benchmarks/snu-npb/nauseous-omp/UA/src/transfer.c(377),0,152,0.5197,2,0.5696,0.2158,0.007194,0.03448,0.03448,174,112,62,143,81,62
/home/s1736883/Work/PParMetrics/benchmarks/snu-npb/nauseous-omp/UA/src/transfer.c(416),0,110,0.5636,3,0.5806,0.2753,0.005618,0.02778,0.02778,108,73,35,84,49,35
/home/s1736883/Work/PParMetrics/benchmarks/snu-npb/nauseous-omp/UA/src/transfer.c(362),1,42,0.8095,2,0.2059,0.3913,0.02174,0.1111,0.1111,36,33,3,10,7,3
/home/s1736883/Work/PParMetrics/benchmarks/snu-npb/nauseous-omp/UA/src/transfer.c(392),0,84,0.631,2,0.5094,0.298,0.006623,0.03448,0.03448,87,61,26,64,38,26
/home/s1736883/Work/PParMetrics/benchmarks/snu-npb/nauseous-omp/UA/src/transfer.c(419),1,55,0.8182,2,0.1333,0.4083,0.03333,0.04444,0.04444,45,43,2,8,6,2
/home/s1736883/Work/PParMetrics/benchmarks/snu-npb/nauseous-omp/UA/src/transfer.c(394),1,33,0.7576,1,0.12,0.3803,0.02817,0.04167,0.04167,24,23,1,4,3,1
/home/s1736883/Work/PParMetrics/benchmarks/snu-npb/nauseous-omp/UA/src/transfer.c(288),1,14,0.1429,0,0,0.06061,0,0,0,0,0,0,0,0,0
/home/s1736883/Work/PParMetrics/benchmarks/snu-npb/nauseous-omp/UA/src/transfer.c(599),1,24,0.6667,1,0.1875,0.3396,0.03774,0.06667,0.06667,15,14,1,4,3,1
/home/s1736883/Work/PParMetrics/benchmarks/snu-npb/nauseous-omp/UA/src/transfer.c(593),1,24,0.6667,1,0.1875,0.3396,0.03774,0.06667,0.06667,15,14,1,4,3,1
/home/s1736883/Work/PParMetrics/benchmarks/snu-npb/nauseous-omp/UA/src/transfer.c(588),1,24,0.6667,1,0.1875,0.3396,0.03774,0.06667,0.06667,15,14,1,4,3,1
/home/s1736883/Work/PParMetrics/benchmarks/snu-npb/nauseous-omp/UA/src/transfer.c(662),1,21,0.619,1,0.2308,0.3191,0.04255,0.08333,0.08333,12,11,1,4,3,1
/home/s1736883/Work/PParMetrics/benchmarks/snu-npb/nauseous-omp/UA/src/transfer.c(657),1,42,0.2143,1,0.6667,0.09091,0,0,0,16,8,8,16,8,8
/home/s1736883/Work/PParMetrics/benchmarks/snu-npb/nauseous-omp/UA/src/transfer.c(650),1,21,0.619,1,0.2308,0.3191,0.04255,0.08333,0.08333,12,11,1,4,3,1
/home/s1736883/Work/PParMetrics/benchmarks/snu-npb/nauseous-omp/UA/src/transfer.c(644),1,42,0,0,0,0,0,0,0,0,0,0,0,0,0
/home/s1736883/Work/PParMetrics/benchmarks/snu-npb/nauseous-omp/UA/src/transfer.c(645),0,32,0.75,1,0.2083,0.3662,0.02817,0.16,0.16,25,23,2,8,6,2
/home/s1736883/Work/PParMetrics/benchmarks/snu-npb/nauseous-omp/UA/src/transfer.c(637),1,24,0.6667,1,0.1875,0.3396,0.03774,0.06667,0.06667,15,14,1,4,3,1
/home/s1736883/Work/PParMetrics/benchmarks/snu-npb/nauseous-omp/UA/src/transfer.c(632),1,21,0.619,1,0.2308,0.3191,0.04255,0.08333,0.08333,12,11,1,4,3,1
/home/s1736883/Work/PParMetrics/benchmarks/snu-npb/nauseous-omp/UA/src/transfer.c(624),1,53,0.3962,2,0.5238,0.1948,0.02597,0.05556,0.05556,36,22,14,29,15,14
/home/s1736883/Work/PParMetrics/benchmarks/snu-npb/nauseous-omp/UA/src/transfer.c(694),0,86,0.1977,1,0.4706,0.1296,0.04938,0.09375,0.09375,32,22,10,23,13,10
/home/s1736883/Work/PParMetrics/benchmarks/snu-npb/nauseous-omp/UA/src/transfer.c(697),1,51,0,0,0,0,0,0,0,0,0,0,0,0,0
/home/s1736883/Work/PParMetrics/benchmarks/snu-npb/nauseous-omp/UA/src/transfer.c(698),0,41,0.8049,1,0.1818,0.3846,0.02198,0.1111,0.1111,36,33,3,11,8,3
/home/s1736883/Work/PParMetrics/benchmarks/snu-npb/nauseous-omp/UA/src/transfer.c(684),1,76,0.3553,2,0.5556,0.1562,0.01562,0.06061,0.06061,66,39,27,55,28,27
/home/s1736883/Work/PParMetrics/benchmarks/snu-npb/nauseous-omp/UA/src/transfer.c(687),1,50,0,0,0,0,0,0,0,0,0,0,0,0,0
/home/s1736883/Work/PParMetrics/benchmarks/snu-npb/nauseous-omp/UA/src/transfer.c(688),0,40,0.8,1,0.1562,0.3908,0.02299,0.1212,0.1212,33,31,2,8,6,2
/home/s1736883/Work/PParMetrics/benchmarks/snu-npb/nauseous-omp/UA/src/transfer.c(715),0,47,0.1915,1,0.6667,0.08696,0,0,0,16,8,8,16,8,8
/home/s1736883/Work/PParMetrics/benchmarks/snu-npb/nauseous-omp/UA/src/transfer.c(716),0,37,0.7838,1,0.2069,0.3735,0.0241,0.125,0.125,32,29,3,11,8,3
/home/s1736883/Work/PParMetrics/benchmarks/snu-npb/nauseous-omp/UA/src/transfer.c(767),1,79,0.3671,2,0.5172,0.1818,0.02479,0.05556,0.05556,54,34,20,43,23,20
/home/s1736883/Work/PParMetrics/benchmarks/snu-npb/nauseous-omp/UA/src/transfer.c(769),1,51,0,0,0,0,0,0,0,0,0,0,0,0,0
/home/s1736883/Work/PParMetrics/benchmarks/snu-npb/nauseous-omp/UA/src/transfer.c(770),1,41,0.8049,1,0.1818,0.3846,0.02198,0.1111,0.1111,36,33,3,11,8,3
/home/s1736883/Work/PParMetrics/benchmarks/snu-npb/nauseous-omp/UA/src/transfer.c(760),1,66,0.1667,1,0.7273,0.06897,0,0,0,24,12,12,24,12,12
/home/s1736883/Work/PParMetrics/benchmarks/snu-npb/nauseous-omp/UA/src/transfer.c(761),1,56,0.8214,1,0.2174,0.3937,0.0315,0.1176,0.1176,51,47,4,17,13,4
/home/s1736883/Work/PParMetrics/benchmarks/snu-npb/nauseous-omp/UA/src/transfer.c(740),1,112,0.1161,2,0.6923,0.06417,0.02674,0.12,0.12,25,15,10,21,11,10
/home/s1736883/Work/PParMetrics/benchmarks/snu-npb/nauseous-omp/UA/src/transfer.c(748),1,50,0,0,0,0,0,0,0,0,0,0,0,0,0
/home/s1736883/Work/PParMetrics/benchmarks/snu-npb/nauseous-omp/UA/src/transfer.c(749),0,40,0.8,1,0.1562,0.3908,0.02299,0.1212,0.1212,33,31,2,8,6,2
/home/s1736883/Work/PParMetrics/benchmarks/snu-npb/nauseous-omp/UA/src/transfer.c(821),1,79,0.3671,2,0.5172,0.1818,0.02479,0.05556,0.05556,54,34,20,43,23,20
/home/s1736883/Work/PParMetrics/benchmarks/snu-npb/nauseous-omp/UA/src/transfer.c(823),1,51,0,0,0,0,0,0,0,0,0,0,0,0,0
/home/s1736883/Work/PParMetrics/benchmarks/snu-npb/nauseous-omp/UA/src/transfer.c(824),1,41,0.8049,1,0.1818,0.3846,0.02198,0.1111,0.1111,36,33,3,11,8,3
/home/s1736883/Work/PParMetrics/benchmarks/snu-npb/nauseous-omp/UA/src/transfer.c(812),1,65,0.1692,1,0.7273,0.06897,0,0,0,24,12,12,24,12,12
/home/s1736883/Work/PParMetrics/benchmarks/snu-npb/nauseous-omp/UA/src/transfer.c(813),1,55,0.8182,1,0.2,0.392,0.032,0.12,0.12,50,46,4,16,12,4
/home/s1736883/Work/PParMetrics/benchmarks/snu-npb/nauseous-omp/UA/src/transfer.c(795),1,112,0.1161,2,0.6923,0.06417,0.02674,0.12,0.12,25,15,10,21,11,10
/home/s1736883/Work/PParMetrics/benchmarks/snu-npb/nauseous-omp/UA/src/transfer.c(799),0,34,0.7647,1,0.1154,0.3836,0.0274,0.12,0.12,25,24,1,4,3,1
/home/s1736883/Work/PParMetrics/benchmarks/snu-npb/nauseous-omp/UA/src/transfer.c(803),1,50,0,0,0,0,0,0,0,0,0,0,0,0,0
/home/s1736883/Work/PParMetrics/benchmarks/snu-npb/nauseous-omp/UA/src/transfer.c(804),0,40,0.8,1,0.1562,0.3908,0.02299,0.1212,0.1212,33,31,2,8,6,2
/home/s1736883/Work/PParMetrics/benchmarks/snu-npb/nauseous-omp/UA/src/transfer.c(850),1,573,0,0,0,0,0,0,0,0,0,0,0,0,0
/home/s1736883/Work/PParMetrics/benchmarks/snu-npb/nauseous-omp/UA/src/transfer.c(851),0,562,0.4359,10,0.3796,0.1407,0.0179,0.04661,0.04237,944,550,382,780,398,382
/home/s1736883/Work/PParMetrics/benchmarks/snu-npb/nauseous-omp/UA/src/transfer.c(878),0,70,0,0,0,0,0,0,0,0,0,0,0,0,0
/home/s1736883/Work/PParMetrics/benchmarks/snu-npb/nauseous-omp/UA/src/transfer.c(890),0,57,0.8596,3,0.2449,0.4016,0.01575,0.1786,0.1786,56,49,7,18,11,7
/home/s1736883/Work/PParMetrics/benchmarks/snu-npb/nauseous-omp/UA/src/transfer.c(901),0,57,0.8596,3,0.2449,0.4016,0.01575,0.1786,0.1786,56,49,7,18,11,7
/home/s1736883/Work/PParMetrics/benchmarks/snu-npb/nauseous-omp/UA/src/transfer.c(912),0,57,0.8596,3,0.2449,0.4016,0.01575,0.1786,0.1786,56,49,7,18,11,7
/home/s1736883/Work/PParMetrics/benchmarks/snu-npb/nauseous-omp/UA/src/transfer.c(923),0,57,0.8596,3,0.2449,0.4016,0.01575,0.1786,0.1786,56,49,7,18,11,7
/home/s1736883/Work/PParMetrics/benchmarks/snu-npb/nauseous-omp/UA/src/transfer.c(879),0,60,0.8667,3,0.2115,0.406,0.01504,0.1695,0.1695,59,52,7,17,10,7
/home/s1736883/Work/PParMetrics/benchmarks/snu-npb/nauseous-omp/UA/src/transfer.c(845),1,13,0.3846,0,0,0.2222,0.03704,0,0,2,2,0,0,0,0
/home/s1736883/Work/PParMetrics/benchmarks/snu-npb/nauseous-omp/UA/src/transfer.c(964),1,654,0,0,0,0,0,0,0,0,0,0,0,0,0
/home/s1736883/Work/PParMetrics/benchmarks/snu-npb/nauseous-omp/UA/src/transfer.c(965),0,643,0.4526,10,0.4227,0.1236,0.01351,0.04559,0.04255,1316,752,552,1128,576,552
/home/s1736883/Work/PParMetrics/benchmarks/snu-npb/nauseous-omp/UA/src/transfer.c(997),0,79,0.1139,1,0.6667,0.06667,0,0,0,16,8,8,16,8,8
/home/s1736883/Work/PParMetrics/benchmarks/snu-npb/nauseous-omp/UA/src/transfer.c(1010),0,66,0.8788,3,0.2931,0.3947,0.01316,0.1944,0.1944,72,61,11,28,17,11
/home/s1736883/Work/PParMetrics/benchmarks/snu-npb/nauseous-omp/UA/src/transfer.c(1022),0,66,0.8788,3,0.2931,0.3947,0.01316,0.1944,0.1944,72,61,11,28,17,11
/home/s1736883/Work/PParMetrics/benchmarks/snu-npb/nauseous-omp/UA/src/transfer.c(1034),0,66,0.8788,3,0.2931,0.3947,0.01316,0.1944,0.1944,72,61,11,28,17,11
/home/s1736883/Work/PParMetrics/benchmarks/snu-npb/nauseous-omp/UA/src/transfer.c(1046),0,66,0.8788,3,0.2931,0.3947,0.01316,0.1944,0.1944,72,61,11,28,17,11
/home/s1736883/Work/PParMetrics/benchmarks/snu-npb/nauseous-omp/UA/src/transfer.c(998),0,69,0.8841,3,0.2623,0.3987,0.01266,0.1867,0.1867,75,64,11,27,16,11
/home/s1736883/Work/PParMetrics/benchmarks/snu-npb/nauseous-omp/UA/src/transfer.c(959),1,13,0.3846,0,0,0.2222,0.03704,0,0,2,2,0,0,0,0
/home/s1736883/Work/PParMetrics/benchmarks/snu-npb/nauseous-omp/UA/src/transfer.c(955),1,13,0.3846,0,0,0.2222,0.03704,0,0,2,2,0,0,0,0
/home/s1736883/Work/PParMetrics/benchmarks/snu-npb/nauseous-omp/UA/src/ua.c(452),0,60,0.7833,1,0.1277,0.2574,0.02941,0.1324,0.08824,68,44,8,16,8,8
/home/s1736883/Work/PParMetrics/benchmarks/snu-npb/nauseous-omp/UA/src/ua.c(446),1,14,0.4286,0,0,0.2581,0.06452,0,0,3,3,0,0,0,0
/home/s1736883/Work/PParMetrics/benchmarks/snu-npb/nauseous-omp/UA/src/ua.c(347),1,236,0.3856,5,0.4835,0.1101,0.004405,0.02422,0.01384,289,147,126,256,130,126
/home/s1736883/Work/PParMetrics/benchmarks/snu-npb/nauseous-omp/UA/src/ua.c(354),1,14,0.2857,0,0,0.1724,0.03448,0,0,0,0,0,0,0,0
/home/s1736883/Work/PParMetrics/benchmarks/snu-npb/nauseous-omp/UA/src/ua.c(373),1,22,0.5455,0,0,0.3061,0.06122,0,0,9,9,0,0,0,0
/home/s1736883/Work/PParMetrics/benchmarks/snu-npb/nauseous-omp/UA/src/ua.c(379),1,79,0.1266,1,0.7,0.04545,0,0,0,20,10,10,20,10,10
/home/s1736883/Work/PParMetrics/benchmarks/snu-npb/nauseous-omp/UA/src/ua.c(398),1,35,0.2571,1,0.6667,0.1,0,0,0,16,8,8,16,8,8
/home/s1736883/Work/PParMetrics/benchmarks/snu-npb/nauseous-omp/UA/src/ua.c(380),1,68,0,0,0,0,0,0,0,0,0,0,0,0,0
/home/s1736883/Work/PParMetrics/benchmarks/snu-npb/nauseous-omp/UA/src/ua.c(399),0,24,0.3333,0,0,0.1837,0.02041,0,0,4,4,0,0,0,0
/home/s1736883/Work/PParMetrics/benchmarks/snu-npb/nauseous-omp/UA/src/ua.c(381),1,58,0,0,0,0,0,0,0,0,0,0,0,0,0
/home/s1736883/Work/PParMetrics/benchmarks/snu-npb/nauseous-omp/UA/src/ua.c(382),1,48,0.8125,1,0.07692,0.4078,0.02913,0.07895,0.07895,38,37,1,4,3,1
/home/s1736883/Work/PParMetrics/benchmarks/snu-npb/nauseous-omp/UA/src/ua.c(314),1,10,0.3,0,0,0.1905,0.04762,0,0,0,0,0,0,0,0
/home/s1736883/Work/PParMetrics/benchmarks/snu-npb/nauseous-omp/UA/src/ua.c(288),0,5,0.2,0,0,0.125,0,0,0,0,0,0,0,0,0
/home/s1736883/Work/PParMetrics/benchmarks/snu-npb/nauseous-omp/UA/src/ua.c(286),0,5,0.2,0,0,0.125,0,0,0,0,0,0,0,0,0
/home/s1736883/Work/PParMetrics/benchmarks/snu-npb/nauseous-omp/UA/src/ua.c(284),0,5,0.2,0,0,0.125,0,0,0,0,0,0,0,0,0
/home/s1736883/Work/PParMetrics/benchmarks/snu-npb/nauseous-omp/UA/src/utils.c(45),1,20,0.55,1,0.2727,0.2889,0.04444,0.2,0.2,10,9,1,4,3,1
/home/s1736883/Work/PParMetrics/benchmarks/snu-npb/nauseous-omp/UA/src/utils.c(59),1,15,0.4667,0,0,0.2581,0.03226,0,0,4,4,0,0,0,0
/home/s1736883/Work/PParMetrics/benchmarks/snu-npb/nauseous-omp/UA/src/utils.c(72),1,15,0.4667,0,0,0.2581,0.03226,0,0,4,4,0,0,0,0
/home/s1736883/Work/PParMetrics/benchmarks/snu-npb/nauseous-omp/UA/src/utils.c(86),1,15,0.4667,0,0,0.2581,0.03226,0,0,4,4,0,0,0,0
/home/s1736883/Work/PParMetrics/benchmarks/snu-npb/nauseous-omp/UA/src/utils.c(99),1,15,0.4667,0,0,0.2581,0.03226,0,0,4,4,0,0,0,0
/home/s1736883/Work/PParMetrics/benchmarks/snu-npb/nauseous-omp/UA/src/utils.c(113),1,15,0.4667,0,0,0.2581,0.03226,0,0,4,4,0,0,0,0
/home/s1736883/Work/PParMetrics/benchmarks/snu-npb/nauseous-omp/UA/src/utils.c(126),1,15,0.4667,0,0,0.2581,0.03226,0,0,4,4,0,0,0,0
/home/s1736883/Work/PParMetrics/benchmarks/snu-npb/nauseous-omp/UA/src/utils.c(139),0,19,0.5263,1,0.2,0.2791,0.04651,0.2222,0.2222,9,8,1,3,2,1
/home/s1736883/Work/PParMetrics/benchmarks/snu-npb/nauseous-omp/UA/src/utils.c(152),0,19,0.5263,1,0.2,0.2791,0.04651,0.2222,0.2222,9,8,1,3,2,1
/home/s1736883/Work/PParMetrics/benchmarks/snu-npb/nauseous-omp/UA/src/utils.c(165),1,27,0.6296,1,0.2941,0.3175,0.04762,0.2222,0.2222,18,16,2,8,6,2
/home/s1736883/Work/PParMetrics/benchmarks/snu-npb/nauseous-omp/UA/src/utils.c(178),1,27,0.6296,1,0.2941,0.3175,0.04762,0.2222,0.2222,18,16,2,8,6,2
/home/s1736883/Work/PParMetrics/benchmarks/snu-npb/nauseous-omp/UA/src/utils.c(192),1,25,0.6,1,0.2667,0.3051,0.05085,0.1875,0.1875,16,14,2,7,5,2
/home/s1736883/Work/PParMetrics/benchmarks/snu-npb/nauseous-omp/UA/src/utils.c(205),0,14,0.4286,0,0,0.2414,0.03448,0,0,3,3,0,0,0,0
/home/s1736883/Work/PParMetrics/benchmarks/snu-npb/nauseous-omp/UA/src/utils.c(218),1,25,0.6,1,0.2667,0.3051,0.05085,0.1875,0.1875,16,14,2,7,5,2
/home/s1736883/Work/PParMetrics/benchmarks/snu-npb/nauseous-omp/UA/src/utils.c(236),1,90,0.2444,4,0.7273,0.1239,0.00885,0.02632,0.02632,38,22,16,34,18,16
/home/s1736883/Work/PParMetrics/benchmarks/snu-npb/nauseous-omp/UA/src/utils.c(239),1,69,0,0,0,0,0,0,0,0,0,0,0,0,0
/home/s1736883/Work/PParMetrics/benchmarks/snu-npb/nauseous-omp/UA/src/utils.c(240),1,59,0,0,0,0,0,0,0,0,0,0,0,0,0
/home/s1736883/Work/PParMetrics/benchmarks/snu-npb/nauseous-omp/UA/src/utils.c(241),1,49,0.8163,1,0.075,0.4095,0.02857,0.02564,0.02564,39,38,1,4,3,1
/home/s1736883/Work/PParMetrics/benchmarks/snu-npb/nauseous-omp/UA/src/utils.c(270),0,122,0.582,3,0.9155,0.09579,0,0.02273,0.009091,220,116,90,212,113,90
/home/s1736883/Work/PParMetrics/benchmarks/snu-npb/nauseous-omp/UA/src/utils.c(273),1,49,0.2653,2,0.6154,0.1096,0.0137,0.05,0.05,20,11,9,18,9,9
/home/s1736883/Work/PParMetrics/benchmarks/snu-npb/nauseous-omp/UA/src/utils.c(285),1,27,0.6667,1,0.1667,0.339,0.0339,0.1765,0.1765,17,16,1,4,3,1
/home/s1736883/Work/PParMetrics/benchmarks/snu-npb/nauseous-omp/UA/src/utils.c(275),1,26,0.6923,1,0.1667,0.3509,0.03509,0.1765,0.1765,17,16,1,4,3,1
/home/s1736883/Work/PParMetrics/benchmarks/snu-npb/nauseous-omp/UA/src/utils.c(326),1,47,0.2128,1,0.5,0.12,0,0.07143,0.07143,14,8,6,12,6,6
/home/s1736883/Work/PParMetrics/benchmarks/snu-npb/nauseous-omp/UA/src/utils.c(327),1,34,0.2941,1,0.5,0.1579,0,0.07143,0.07143,14,8,6,12,6,6
/home/s1736883/Work/PParMetrics/benchmarks/snu-npb/nauseous-omp/UA/src/utils.c(328),1,21,0.619,0,0,0.3256,0.02326,0,0,10,10,0,0,0,0
